a	Präposition	A1
abitare	Verb	A1
aceto	Substantiv	A1
acqua	Substantiv	A1
adesso	Adverb	A1
aereo	Substantiv	A1
aeroplano	Substantiv	A1
aeroporto	Substantiv	A1
affetto	Substantiv	A1
agenzia	Substantiv	A1
agosto	Substantiv	A1
aiuto	Interjektion	A1
albergo	Substantiv	A1
albero	Substantiv	A1
alfabeto	Substantiv	A1
alto	Adjektiv	A1
amare	Verb	A1
ambasciata	Substantiv	A1
amica	Substantiv	A1
amico	Substantiv	A1
amore	Substantiv	A1
anche	Konjunktion	A1
andare	Verb	A1
animale	Substantiv	A1
anno	Substantiv	A1
appartamento	Substantiv	A1
appuntamento	Substantiv	A1
aprile	Substantiv	A1
aprire	Verb	A1
arrivare	Verb	A1
arrivederci	Interjektion	A1
arte	Substantiv	A1
ascoltare	Verb	A1
aspettare	Verb	A1
attento	Adjektiv	A1
attenzione	Substantiv	A1
augurio	Substantiv	A1
autobus	Substantiv	A1
autunno	Substantiv	A1
avanti	Adverb	A1
avere	Verb	A1
bacio	Substantiv	A1
bagno	Substantiv	A1
ballare	Verb	A1
bambina	Substantiv	A1
bambino	Substantiv	A1
banca	Substantiv	A1
bar	Substantiv	A1
bello	Adjektiv	A1
bene	Adverb	A1
bere	Verb	A1
bianco	Adjektiv	A1
bicchiere	Substantiv	A1
bici	Substantiv	A1
bicicletta	Substantiv	A1
biglietto	Substantiv	A1
biondo	Adjektiv	A1
birra	Substantiv	A1
blu	Adjektiv	A1
borsa	Substantiv	A1
bottiglia	Substantiv	A1
bravo	Adjektiv	A1
bravo	Interjektion	A1
buonanotte	Interjektion	A1
buonasera	Interjektion	A1
buongiorno	Interjektion	A1
buono	Adjektiv	A1
busta	Substantiv	A1
caffè	Substantiv	A1
caldo	Adjektiv	A1
calza	Substantiv	A1
cambiare	Verb	A1
camera	Substantiv	A1
cameriera	Substantiv	A1
cameriere	Substantiv	A1
camicia	Substantiv	A1
campagna	Substantiv	A1
cane	Substantiv	A1
cantare	Verb	A1
canzone	Substantiv	A1
capello	Substantiv	A1
capire	Verb	A1
cappotto	Substantiv	A1
cappuccino	Substantiv	A1
carne	Substantiv	A1
caro	Adjektiv	A1
carta	Substantiv	A1
cartolina	Substantiv	A1
casa	Substantiv	A1
castano	Adjektiv	A1
cd	Substantiv	A1
cellulare	Substantiv	A1
cena	Substantiv	A1
cenare	Verb	A1
centro	Substantiv	A1
cercare	Verb	A1
certo	Adverb	A1
che	Pronomen	A1
check-in	Substantiv	A1
chi	Pronomen	A1
chiamare	Verb	A1
chiamarsi	Verb	A1
chiave	Substantiv	A1
chiesa	Substantiv	A1
chiudere	Verb	A1
ci	Pronominalpartikel	A1
ciao	Interjektion	A1
cibo	Substantiv	A1
cin-cin	Interjektion	A1
cinema	Substantiv	A1
città	Substantiv	A1
classe	Substantiv	A1
cognome	Substantiv	A1
colazione	Substantiv	A1
colore	Substantiv	A1
coltello	Substantiv	A1
come	Adverb	A1
cominciare	Verb	A1
compagna	Substantiv	A1
compagno	Substantiv	A1
compleanno	Substantiv	A1
comprare	Verb	A1
computer	Substantiv	A1
con	Präposition	A1
consolato	Substantiv	A1
conto	Substantiv	A1
corso	Substantiv	A1
corto	Adjektiv	A1
cosa	Substantiv	A1
costare	Verb	A1
credito	Substantiv	A1
cucchiaio	Substantiv	A1
cucina	Substantiv	A1
dare	Verb	A1
data	Substantiv	A1
davanti	Adverb	A1
dentro	Adverb	A1
destra	Substantiv	A1
di	Präposition	A1
dicembre	Substantiv	A1
dietro	Adverb	A1
difficile	Adjektiv	A1
dire	Verb	A1
doccia	Substantiv	A1
documento	Substantiv	A1
domanda	Substantiv	A1
domandare	Verb	A1
domani	Adverb	A1
domenica	Substantiv	A1
donna	Substantiv	A1
dopo	Adverb	A1
doppio	Adjektiv	A1
dormire	Verb	A1
dottore	Substantiv	A1
dottoressa	Substantiv	A1
dove	Adverb	A1
dovere	Verb	A1
e	Konjunktion	A1
e-mail	Substantiv	A1
entrare	Verb	A1
esercizio	Substantiv	A1
essere	Verb	A1
estate	Substantiv	A1
estero	Substantiv	A1
euro	Substantiv	A1
fabbrica	Substantiv	A1
facile	Adjektiv	A1
falso	Adjektiv	A1
fame	Substantiv	A1
famiglia	Substantiv	A1
fare	Verb	A1
farmacia	Substantiv	A1
favore	Substantiv	A1
fax	Substantiv	A1
febbraio	Substantiv	A1
felice	Adjektiv	A1
femmina	Substantiv	A1
fermata	Substantiv	A1
festa	Substantiv	A1
figlia	Substantiv	A1
figlio	Substantiv	A1
film	Substantiv	A1
finestra	Substantiv	A1
finire	Verb	A1
fiore	Substantiv	A1
forchetta	Substantiv	A1
fotografia	Substantiv	A1
francobollo	Substantiv	A1
fratello	Substantiv	A1
freddo	Adjektiv	A1
frutta	Substantiv	A1
fumare	Verb	A1
fuori	Adverb	A1
gatto	Substantiv	A1
gennaio	Substantiv	A1
gentile	Adjektiv	A1
giacca	Substantiv	A1
giallo	Adjektiv	A1
giardino	Substantiv	A1
giocare	Verb	A1
giornale	Substantiv	A1
giornata	Substantiv	A1
giorno	Substantiv	A1
giovane	Adjektiv	A1
giovedì	Substantiv	A1
giù	Adverb	A1
giugno	Substantiv	A1
gli	Artikel	A1
gonna	Substantiv	A1
grande	Adjektiv	A1
grazie	Interjektion	A1
guardare	Verb	A1
hobby	Substantiv	A1
hotel	Substantiv	A1
i	Artikel	A1
ieri	Adverb	A1
il	Artikel	A1
imparare	Verb	A1
importante	Adjektiv	A1
in	Präposition	A1
incontrare	Verb	A1
indietro	Adverb	A1
indirizzo	Substantiv	A1
industria	Substantiv	A1
informazione	Substantiv	A1
insegnante	Substantiv	A1
insegnare	Verb	A1
intelligente	Adjektiv	A1
interessante	Adjektiv	A1
internazionale	Adjektiv	A1
internet	Substantiv	A1
inverno	Substantiv	A1
io	Pronomen	A1
italiano	Substantiv	A1
la	Artikel	A1
là	Adverb	A1
lago	Substantiv	A1
largo	Adjektiv	A1
latte	Substantiv	A1
lavorare	Verb	A1
lavoro	Substantiv	A1
le	Artikel	A1
leggere	Verb	A1
lei	Pronomen	A1
lettera	Substantiv	A1
letto	Substantiv	A1
lezione	Substantiv	A1
lì	Adverb	A1
libro	Substantiv	A1
lingua	Substantiv	A1
lo	Artikel	A1
lontano	Adverb	A1
loro	Pronomen	A1
luglio	Substantiv	A1
lui	Pronomen	A1
lunedì	Substantiv	A1
lungo	Adjektiv	A1
macchina	Substantiv	A1
madre	Substantiv	A1
maggio	Substantiv	A1
maglietta	Substantiv	A1
maglione	Substantiv	A1
magro	Adjektiv	A1
mai	Adverb	A1
malato	Adjektiv	A1
male	Adverb	A1
mamma	Substantiv	A1
mangiare	Verb	A1
mare	Substantiv	A1
marito	Substantiv	A1
martedì	Substantiv	A1
marzo	Substantiv	A1
maschio	Substantiv	A1
matita	Substantiv	A1
mattina	Substantiv	A1
me	Pronomen	A1
medicina	Substantiv	A1
meno	Adverb	A1
menù	Substantiv	A1
mercato	Substantiv	A1
mercoledì	Substantiv	A1
mese	Substantiv	A1
metà	Substantiv	A1
mettere	Verb	A1
mezzanotte	Substantiv	A1
mezzo	Adjektiv	A1
mezzogiorno	Substantiv	A1
mi	Pronomen	A1
minuto	Substantiv	A1
mio	Adjektiv	A1
moglie	Substantiv	A1
molto	Adjektiv	A1
molto	Adverb	A1
momento	Substantiv	A1
montagna	Substantiv	A1
morire	Verb	A1
moto	Substantiv	A1
motocicletta	Substantiv	A1
museo	Substantiv	A1
musica	Substantiv	A1
nascere	Verb	A1
Natale	Substantiv	A1
nazionalità	Substantiv	A1
nazione	Substantiv	A1
negozio	Substantiv	A1
nero	Adjektiv	A1
nessuno	Pronomen	A1
niente	Pronomen	A1
niente	Adverb	A1
no	Adverb	A1
noi	Pronomen	A1
nome	Substantiv	A1
non	Adverb	A1
nonna	Substantiv	A1
nonno	Substantiv	A1
notte	Substantiv	A1
novembre	Substantiv	A1
numero	Substantiv	A1
nuovo	Adjektiv	A1
o	Konjunktion	A1
occhiale	Substantiv	A1
oggi	Adverb	A1
olio	Substantiv	A1
ombrello	Substantiv	A1
ora	Substantiv	A1
ora	Adverb	A1
orologio	Substantiv	A1
ospedale	Substantiv	A1
ottobre	Substantiv	A1
pacco	Substantiv	A1
padre	Substantiv	A1
pagare	Verb	A1
pane	Substantiv	A1
pantalone	Substantiv	A1
papà	Substantiv	A1
parcheggio	Substantiv	A1
parco	Substantiv	A1
parlare	Verb	A1
parola	Substantiv	A1
partire	Verb	A1
Pasqua	Substantiv	A1
passaporto	Substantiv	A1
pasta	Substantiv	A1
penna	Substantiv	A1
pepe	Substantiv	A1
per	Präposition	A1
perché	Adverb	A1
perché	Konjunktion	A1
pesce	Substantiv	A1
piacere	Verb	A1
piacere	Substantiv	A1
piano	Adverb	A1
piano	Substantiv	A1
pianta	Substantiv	A1
piatto	Substantiv	A1
piazza	Substantiv	A1
piccolo	Adjektiv	A1
piovere	Verb	A1
più	Adverb	A1
pizza	Substantiv	A1
pizzeria	Substantiv	A1
po’	Adverb	A1
poco	Adjektiv	A1
poco	Adverb	A1
polizia	Substantiv	A1
pomeriggio	Substantiv	A1
pomodoro	Substantiv	A1
porta	Substantiv	A1
portare	Verb	A1
posta	Substantiv	A1
posto	Substantiv	A1
potere	Verb	A1
pranzare	Verb	A1
pranzo	Substantiv	A1
prego	Interjektion	A1
prendere	Verb	A1
prenotare	Verb	A1
presto	Adverb	A1
prezzo	Substantiv	A1
primavera	Substantiv	A1
professore	Substantiv	A1
professoressa	Substantiv	A1
pulire	Verb	A1
qua	Adverb	A1
quaderno	Substantiv	A1
quadro	Substantiv	A1
quale	Pronomen	A1
quando	Adverb	A1
quanto	Adjektiv	A1
quanto	Pronomen	A1
quanto	Adverb	A1
quarto	Substantiv	A1
quasi	Adverb	A1
quello	Adjektiv	A1
quello	Pronomen	A1
questo	Adjektiv	A1
questo	Pronomen	A1
qui	Adverb	A1
radio	Substantiv	A1
ragazza	Substantiv	A1
ragazzo	Substantiv	A1
ricco	Adjektiv	A1
ripetere	Verb	A1
riso	Substantiv	A1
rispondere	Verb	A1
risposta	Substantiv	A1
ristorante	Substantiv	A1
ritornare	Verb	A1
rosso	Adjektiv	A1
sabato	Substantiv	A1
sale	Substantiv	A1
salute	Interjektion	A1
saluto	Substantiv	A1
sapere	Verb	A1
scarpa	Substantiv	A1
scrivere	Verb	A1
scuola	Substantiv	A1
scusare	Verb	A1
secondo	Substantiv	A1
sedia	Substantiv	A1
segreteria	Substantiv	A1
sempre	Adverb	A1
senza	Präposition	A1
sera	Substantiv	A1
sete	Substantiv	A1
settembre	Substantiv	A1
settimana	Substantiv	A1
si	Pronomen	A1
sì	Adverb	A1
sigaretta	Substantiv	A1
significare	Verb	A1
signora	Substantiv	A1
signore	Substantiv	A1
simpatico	Adjektiv	A1
singolo	Adjektiv	A1
sinistra	Substantiv	A1
soggiorno	Substantiv	A1
soldo	Substantiv	A1
sole	Substantiv	A1
sonno	Substantiv	A1
sopra	Adverb	A1
sorella	Substantiv	A1
sotto	Adverb	A1
spaghetto	Substantiv	A1
spedire	Verb	A1
spesa	Substantiv	A1
spesso	Adverb	A1
spiaggia	Substantiv	A1
sporco	Adjektiv	A1
sport	Substantiv	A1
sposare	Verb	A1
stanco	Adjektiv	A1
stare	Verb	A1
stazione	Substantiv	A1
stop	Substantiv	A1
strada	Substantiv	A1
straniero	Adjektiv	A1
stretto	Adjektiv	A1
studente	Substantiv	A1
studentessa	Substantiv	A1
studiare	Verb	A1
su	Adverb	A1
suonare	Verb	A1
supermercato	Substantiv	A1
svegliarsi	Verb	A1
tanto	Adjektiv	A1
tanto	Adverb	A1
tardi	Adverb	A1
tavolo	Substantiv	A1
taxi	Substantiv	A1
te	Pronomen	A1
tè	Substantiv	A1
teatro	Substantiv	A1
telefonare	Verb	A1
telefono	Substantiv	A1
televisione	Substantiv	A1
ti	Pronomen	A1
tornare	Verb	A1
treno	Substantiv	A1
triste	Adjektiv	A1
troppo	Adjektiv	A1
troppo	Adverb	A1
trovare	Verb	A1
tu	Pronomen	A1
tuo	Adjektiv	A1
turista	Substantiv	A1
tutto	Adjektiv	A1
tv	Substantiv	A1
ufficio	Substantiv	A1
un	Artikel	A1
una	Artikel	A1
uno	Artikel	A1
università	Substantiv	A1
uomo	Substantiv	A1
uovo	Substantiv	A1
uscire	Verb	A1
vacanza	Substantiv	A1
valigia	Substantiv	A1
vecchio	Adjektiv	A1
vedersi	Verb	A1
venerdì	Substantiv	A1
venire	Verb	A1
verde	Adjektiv	A1
verdura	Substantiv	A1
vero	Adjektiv	A1
vestito	Substantiv	A1
via	Substantiv	A1
viaggiare	Verb	A1
viaggio	Substantiv	A1
vicino	Adverb	A1
vino	Substantiv	A1
visitare	Verb	A1
visto	Substantiv	A1
vivere	Verb	A1
voi	Pronomen	A1
volere	Verb	A1
zaino	Substantiv	A1
zucchero	Substantiv	A1
abbastanza	Adverb	A2
abbonamento	Substantiv	A2
abbracciare	Verb	A2
abbraccio	Substantiv	A2
accendere	Verb	A2
accendino	Substantiv	A2
accompagnare	Verb	A2
accordo	Substantiv	A2
acquistare	Verb	A2
addio	Interjektion	A2
addormentarsi	Verb	A2
adulta	Adjektiv	A2
adulta	Substantiv	A2
adulto	Adjektiv	A2
adulto	Substantiv	A2
affittare	Verb	A2
affitto	Substantiv	A2
aiutare	Verb	A2
aiuto	Substantiv	A2
alcuno	Adjektiv	A2
alimentari	Substantiv	A2
allegro	Adjektiv	A2
allora	Adverb	A2
altro	Pronomen	A2
altro	Adjektiv	A2
alzarsi	Verb	A2
amaro	Adjektiv	A2
ancora	Adverb	A2
anello	Substantiv	A2
annoiarsi	Verb	A2
anticipo	Substantiv	A2
antico	Adjektiv	A2
antipasto	Substantiv	A2
antipatico	Adjektiv	A2
anziana	Adjektiv	A2
anziana	Substantiv	A2
anziano	Adjektiv	A2
anziano	Substantiv	A2
aperitivo	Substantiv	A2
appena	Adverb	A2
appetito	Substantiv	A2
arancia	Substantiv	A2
arancione	Adjektiv	A2
argento	Substantiv	A2
aria	Substantiv	A2
armadio	Substantiv	A2
arrabbiarsi	Verb	A2
arrivo	Substantiv	A2
arrosto	Substantiv	A2
articolo	Substantiv	A2
ascensore	Substantiv	A2
asciugamano	Substantiv	A2
asciugare	Verb	A2
asciugarsi	Verb	A2
attraversare	Verb	A2
aula	Substantiv	A2
auto	Substantiv	A2
automobile	Substantiv	A2
autostrada	Substantiv	A2
azzurro	Adjektiv	A2
baciare	Verb	A2
baffo	Substantiv	A2
balcone	Substantiv	A2
bambola	Substantiv	A2
banana	Substantiv	A2
banco	Substantiv	A2
barba	Substantiv	A2
barca	Substantiv	A2
basso	Adjektiv	A2
basta	Interjektion	A2
benvenuto	Adjektiv	A2
benzina	Substantiv	A2
bibita	Substantiv	A2
biblioteca	Substantiv	A2
biglietteria	Substantiv	A2
bisogno	Substantiv	A2
bistecca	Substantiv	A2
bocca	Substantiv	A2
bosco	Substantiv	A2
braccio	Substantiv	A2
brutto	Adjektiv	A2
buio	Substantiv	A2
burro	Substantiv	A2
calcio	Substantiv	A2
caldo	Substantiv	A2
calmo	Adjektiv	A2
camminare	Verb	A2
campeggio	Substantiv	A2
camper	Substantiv	A2
cantina	Substantiv	A2
capo	Substantiv	A2
cappello	Substantiv	A2
carota	Substantiv	A2
casalinga	Substantiv	A2
casalingo	Substantiv	A2
cassa	Substantiv	A2
cattivo	Adjektiv	A2
cavallo	Substantiv	A2
centimetro	Substantiv	A2
che	Konjunktion	A2
chiaro	Adjektiv	A2
chiedere	Verb	A2
chilo	Substantiv	A2
chilometro	Substantiv	A2
ci	Pronomen	A2
cielo	Substantiv	A2
cioccolato	Substantiv	A2
circa	Adverb	A2
cognata	Substantiv	A2
cognato	Substantiv	A2
collana	Substantiv	A2
collega	Substantiv	A2
collina	Substantiv	A2
colorare	Verb	A2
commessa	Substantiv	A2
commesso	Substantiv	A2
comodino	Substantiv	A2
comodo	Adjektiv	A2
compito	Substantiv	A2
completo	Adjektiv	A2
complimento	Substantiv	A2
concerto	Substantiv	A2
confine	Substantiv	A2
congratulazione	Substantiv	A2
conoscere	Verb	A2
contento	Adjektiv	A2
continuare	Verb	A2
contorno	Substantiv	A2
conversazione	Substantiv	A2
coperta	Substantiv	A2
coppia	Substantiv	A2
corpo	Substantiv	A2
correggere	Verb	A2
correre	Verb	A2
così	Adverb	A2
costo	Substantiv	A2
cotone	Substantiv	A2
credere	Verb	A2
crema	Substantiv	A2
crociera	Substantiv	A2
cucinare	Verb	A2
cugina	Substantiv	A2
cugino	Substantiv	A2
cultura	Substantiv	A2
cuscino	Substantiv	A2
da	Präposition	A2
davanti	Präposition	A2
debole	Adjektiv	A2
dente	Substantiv	A2
dentifricio	Substantiv	A2
dentro	Präposition	A2
dettato	Substantiv	A2
dialogo	Substantiv	A2
dietro	Präposition	A2
dimenticare	Verb	A2
dimenticarsi	Verb	A2
dipingere	Verb	A2
dipinto	Substantiv	A2
direttore	Substantiv	A2
direttrice	Substantiv	A2
discoteca	Substantiv	A2
disegnare	Verb	A2
dispiacere	Verb	A2
distributore	Substantiv	A2
dito	Substantiv	A2
ditta	Substantiv	A2
divano	Substantiv	A2
diverso	Adjektiv	A2
divertente	Adjektiv	A2
divertimento	Substantiv	A2
divertirsi	Verb	A2
divorziare	Verb	A2
dizionario	Substantiv	A2
dogana	Substantiv	A2
dolce	Adjektiv	A2
dolce	Substantiv	A2
dritto	Adverb	A2
durante	Präposition	A2
ecco	Interjektion	A2
economia	Substantiv	A2
elegante	Adjektiv	A2
elementare	Adjektiv	A2
entrata	Substantiv	A2
erba	Substantiv	A2
errore	Substantiv	A2
esame	Substantiv	A2
esempio	Substantiv	A2
est	Substantiv	A2
età	Substantiv	A2
etto	Substantiv	A2
faccia	Substantiv	A2
facoltà	Substantiv	A2
fattoria	Substantiv	A2
febbre	Substantiv	A2
femminile	Adjektiv	A2
fermarsi	Verb	A2
fermo	Adjektiv	A2
ferro	Substantiv	A2
fetta	Substantiv	A2
fiammifero	Substantiv	A2
fidanzata	Substantiv	A2
fidanzato	Substantiv	A2
fine	Substantiv	A2
fino	Präposition	A2
firma	Substantiv	A2
firmare	Verb	A2
fiume	Substantiv	A2
foglio	Substantiv	A2
formaggio	Substantiv	A2
fornello	Substantiv	A2
forno	Substantiv	A2
forse	Adverb	A2
forte	Adjektiv	A2
fortuna	Substantiv	A2
fra	Präposition	A2
frase	Substantiv	A2
freddo	Substantiv	A2
freezer	Substantiv	A2
frequentare	Verb	A2
fresco	Adjektiv	A2
frigorifero	Substantiv	A2
fronte	Substantiv	A2
fulmine	Substantiv	A2
fuoco	Substantiv	A2
gamba	Substantiv	A2
garage	Substantiv	A2
gas	Substantiv	A2
gelato	Substantiv	A2
genero	Substantiv	A2
genitore	Substantiv	A2
geografia	Substantiv	A2
ghiaccio	Substantiv	A2
già	Adverb	A2
ginnastica	Substantiv	A2
giocattolo	Substantiv	A2
gioco	Substantiv	A2
giornalista	Substantiv	A2
girare	Verb	A2
giro	Substantiv	A2
gita	Substantiv	A2
giusto	Adjektiv	A2
gli	Pronomen	A2
grado	Substantiv	A2
grasso	Adjektiv	A2
gratis	Adverb	A2
grigio	Adjektiv	A2
guanto	Substantiv	A2
guida	Substantiv	A2
guidare	Verb	A2
idea	Substantiv	A2
identità	Substantiv	A2
impermeabile	Substantiv	A2
impiegata	Substantiv	A2
impiegato	Substantiv	A2
impossibile	Adjektiv	A2
incontrarsi	Verb	A2
indossare	Verb	A2
infermiera	Substantiv	A2
infermiere	Substantiv	A2
ingegnere	Substantiv	A2
iniziare	Verb	A2
inizio	Substantiv	A2
insalata	Substantiv	A2
insieme	Adverb	A2
intorno	Adverb	A2
inutile	Adjektiv	A2
invitare	Verb	A2
isola	Substantiv	A2
la	Pronomen	A2
lampada	Substantiv	A2
lana	Substantiv	A2
lasciare	Verb	A2
lavagna	Substantiv	A2
lavanderia	Substantiv	A2
lavandino	Substantiv	A2
lavare	Verb	A2
lavarsi	Verb	A2
lavastoviglie	Substantiv	A2
lavatrice	Substantiv	A2
le	Pronomen	A2
leggero	Adjektiv	A2
legno	Substantiv	A2
lento	Adjektiv	A2
lenzuolo	Substantiv	A2
li	Pronomen	A2
libero	Adjektiv	A2
libreria	Substantiv	A2
liscio	Adjektiv	A2
litro	Substantiv	A2
livello	Substantiv	A2
lo	Pronomen	A2
lontano	Adjektiv	A2
loro	Adjektiv	A2
luce	Substantiv	A2
luna	Substantiv	A2
luogo	Substantiv	A2
ma	Konjunktion	A2
maiale	Substantiv	A2
mancia	Substantiv	A2
manica	Substantiv	A2
mano	Substantiv	A2
marrone	Adjektiv	A2
maschile	Adjektiv	A2
matematica	Substantiv	A2
materia	Substantiv	A2
matrimonio	Substantiv	A2
meccanico	Substantiv	A2
medico	Substantiv	A2
meglio	Adverb	A2
mela	Substantiv	A2
mensa	Substantiv	A2
merenda	Substantiv	A2
messaggio	Substantiv	A2
metro	Substantiv	A2
metropolitana	Substantiv	A2
mettersi	Verb	A2
minestra	Substantiv	A2
mio	Pronomen	A2
mobile	Substantiv	A2
moda	Substantiv	A2
moderno	Adjektiv	A2
mondo	Substantiv	A2
monumento	Substantiv	A2
mostra	Substantiv	A2
motorino	Substantiv	A2
mucca	Substantiv	A2
muovere	Verb	A2
muoversi	Verb	A2
muro	Substantiv	A2
naso	Substantiv	A2
natura	Substantiv	A2
nave	Substantiv	A2
nebbia	Substantiv	A2
nervoso	Adjektiv	A2
neve	Substantiv	A2
nevicare	Verb	A2
nipote	Substantiv	A2
noioso	Adjektiv	A2
noleggiare	Verb	A2
nord	Substantiv	A2
normale	Adjektiv	A2
nostalgia	Substantiv	A2
nostro	Adjektiv	A2
nostro	Pronomen	A2
nuora	Substantiv	A2
nuotare	Verb	A2
nuoto	Substantiv	A2
nuvola	Substantiv	A2
nuvoloso	Adjektiv	A2
occhio	Substantiv	A2
odore	Substantiv	A2
offrire	Verb	A2
oggetto	Substantiv	A2
ogni	Adjektiv	A2
ok	Interjektion	A2
operaia	Substantiv	A2
operaio	Substantiv	A2
orario	Substantiv	A2
ordinare	Verb	A2
orecchio	Substantiv	A2
organizzare	Verb	A2
oro	Substantiv	A2
ospite	Substantiv	A2
ovest	Substantiv	A2
padella	Substantiv	A2
padrona	Substantiv	A2
padrone	Substantiv	A2
pagina	Substantiv	A2
paio	Substantiv	A2
palazzo	Substantiv	A2
palestra	Substantiv	A2
palla	Substantiv	A2
pallacanestro	Substantiv	A2
panino	Substantiv	A2
parente	Substantiv	A2
parete	Substantiv	A2
parte	Substantiv	A2
partenza	Substantiv	A2
partita	Substantiv	A2
passare	Verb	A2
passato	Substantiv	A2
passato	Adjektiv	A2
passeggiare	Verb	A2
passeggiata	Substantiv	A2
pasto	Substantiv	A2
patata	Substantiv	A2
patente	Substantiv	A2
paura	Substantiv	A2
pausa	Substantiv	A2
pavimento	Substantiv	A2
peccato	Substantiv	A2
pelle	Substantiv	A2
pensare	Verb	A2
pensione	Substantiv	A2
pentola	Substantiv	A2
pera	Substantiv	A2
perdere	Verb	A2
periferia	Substantiv	A2
persona	Substantiv	A2
pesante	Adjektiv	A2
pescare	Verb	A2
pettine	Substantiv	A2
pezzo	Substantiv	A2
piangere	Verb	A2
piede	Substantiv	A2
pieno	Adjektiv	A2
pigro	Adjektiv	A2
pioggia	Substantiv	A2
pipa	Substantiv	A2
piscina	Substantiv	A2
pisello	Substantiv	A2
plurale	Adjektiv	A2
poi	Adverb	A2
pollo	Substantiv	A2
poltrona	Substantiv	A2
ponte	Substantiv	A2
posacenere	Substantiv	A2
posata	Substantiv	A2
possibile	Adjektiv	A2
povero	Adjektiv	A2
prato	Substantiv	A2
preferire	Verb	A2
preoccuparsi	Verb	A2
preparare	Verb	A2
prima	Adverb	A2
primo	Adjektiv	A2
primo	Substantiv	A2
probabilmente	Adverb	A2
problema	Substantiv	A2
profumo	Substantiv	A2
programma	Substantiv	A2
pronto	Adjektiv	A2
prosciutto	Substantiv	A2
prossimo	Adjektiv	A2
provare	Verb	A2
punto	Substantiv	A2
qualche	Adjektiv	A2
qualcosa	Pronomen	A2
qualcuno	Pronomen	A2
quale	Adjektiv	A2
quando	Konjunktion	A2
raffreddore	Substantiv	A2
ragione	Substantiv	A2
regalare	Verb	A2
regalo	Substantiv	A2
restare	Verb	A2
resto	Substantiv	A2
riccio	Adjektiv	A2
ricevere	Verb	A2
ricordare	Verb	A2
ricordarsi	Verb	A2
ridere	Verb	A2
rilassarsi	Verb	A2
rimanere	Verb	A2
riposare	Verb	A2
riposarsi	Verb	A2
riscaldamento	Substantiv	A2
ritardo	Substantiv	A2
ritrovare	Verb	A2
rompere	Verb	A2
rosa	Adjektiv	A2
roulotte	Substantiv	A2
rumore	Substantiv	A2
sala	Substantiv	A2
salame	Substantiv	A2
salato	Adjektiv	A2
saldo	Substantiv	A2
salotto	Substantiv	A2
salsa	Substantiv	A2
salute	Substantiv	A2
salve	Interjektion	A2
sandalo	Substantiv	A2
sapone	Substantiv	A2
sbagliare	Verb	A2
sbaglio	Substantiv	A2
scala	Substantiv	A2
scegliere	Verb	A2
sci	Substantiv	A2
sciare	Verb	A2
scienza	Substantiv	A2
scomodo	Adjektiv	A2
scontrino	Substantiv	A2
scorso	Adjektiv	A2
scrivania	Substantiv	A2
scuro	Adjektiv	A2
se	Konjunktion	A2
secondo	Präposition	A2
secondo	Adjektiv	A2
sedersi	Verb	A2
segretaria	Substantiv	A2
segretario	Substantiv	A2
seguire	Verb	A2
semaforo	Substantiv	A2
sembrare	Verb	A2
sentire	Verb	A2
sentirsi	Verb	A2
separare	Verb	A2
separarsi	Verb	A2
serio	Adjektiv	A2
seta	Substantiv	A2
shampoo	Substantiv	A2
sicuro	Adjektiv	A2
sigaro	Substantiv	A2
silenzio	Substantiv	A2
simile	Adjektiv	A2
singolare	Adjektiv	A2
soccorso	Substantiv	A2
soffitto	Substantiv	A2
solito	Adjektiv	A2
solo	Adjektiv	A2
solo	Adverb	A2
sopra	Präposition	A2
sorpresa	Substantiv	A2
sorridere	Verb	A2
sotto	Präposition	A2
spazzolino	Substantiv	A2
specchio	Substantiv	A2
spegnere	Verb	A2
spendere	Verb	A2
sperare	Verb	A2
spettacolo	Substantiv	A2
spiegare	Verb	A2
spingere	Verb	A2
spogliarsi	Verb	A2
sporcare	Verb	A2
sportivo	Adjektiv	A2
sposarsi	Verb	A2
spuntino	Substantiv	A2
squadra	Substantiv	A2
stadio	Substantiv	A2
stamattina	Adverb	A2
stanotte	Adverb	A2
stanza	Substantiv	A2
stasera	Adverb	A2
stella	Substantiv	A2
stesso	Adjektiv	A2
stirare	Verb	A2
stiro	Substantiv	A2
stivale	Substantiv	A2
storia	Substantiv	A2
storico	Adjektiv	A2
strano	Adjektiv	A2
studio	Substantiv	A2
su	Präposition	A2
subito	Adverb	A2
succedere	Verb	A2
sud	Substantiv	A2
suo	Adjektiv	A2
suo	Pronomen	A2
suocera	Substantiv	A2
suocero	Substantiv	A2
tabaccaio	Substantiv	A2
tagliare	Verb	A2
tappeto	Substantiv	A2
tasca	Substantiv	A2
tazza	Substantiv	A2
tecnico	Substantiv	A2
telefonata	Substantiv	A2
temperatura	Substantiv	A2
tempo	Substantiv	A2
temporale	Substantiv	A2
tenda	Substantiv	A2
tenere	Verb	A2
tennis	Substantiv	A2
terra	Substantiv	A2
terrazza	Substantiv	A2
testa	Substantiv	A2
tetto	Substantiv	A2
tiepido	Adjektiv	A2
timido	Adjektiv	A2
tirare	Verb	A2
toccare	Verb	A2
togliere	Verb	A2
torta	Substantiv	A2
tortellino	Substantiv	A2
tosse	Substantiv	A2
tovaglia	Substantiv	A2
tovagliolo	Substantiv	A2
tra	Präposition	A2
traffico	Substantiv	A2
tranquillo	Adjektiv	A2
trascorrere	Verb	A2
tuo	Pronomen	A2
tuono	Substantiv	A2
uccello	Substantiv	A2
uguale	Adjektiv	A2
ultimo	Adjektiv	A2
usare	Verb	A2
uscita	Substantiv	A2
utile	Adjektiv	A2
vasca	Substantiv	A2
vaso	Substantiv	A2
vedere	Verb	A2
vedovo	Adjektiv	A2
veloce	Adjektiv	A2
vendere	Verb	A2
vento	Substantiv	A2
veramente	Adverb	A2
verbo	Substantiv	A2
vestirsi	Verb	A2
vetrina	Substantiv	A2
vetro	Substantiv	A2
vi	Pronomen	A2
viola	Adjektiv	A2
virgola	Substantiv	A2
voce	Substantiv	A2
voglia	Substantiv	A2
volare	Verb	A2
volta	Substantiv	A2
vostro	Adjektiv	A2
vostro	Pronomen	A2
vuoto	Adjektiv	A2
water	Substantiv	A2
zia	Substantiv	A2
zio	Substantiv	A2
abitante	Substantiv	B1
accanto	Adverb	B1
accento	Substantiv	B1
accomodarsi	Verb	B1
acconto	Substantiv	B1
acido	Adjektiv	B1
affettuoso	Adjektiv	B1
aggiungere	Verb	B1
aggiustare	Verb	B1
aglio	Substantiv	B1
alba	Substantiv	B1
allergico	Adjektiv	B1
alloggio	Substantiv	B1
almeno	Adverb	B1
ambulanza	Substantiv	B1
ambulatorio	Substantiv	B1
amicizia	Substantiv	B1
ammalarsi	Verb	B1
ammobiliato	Adjektiv	B1
analisi	Substantiv	B1
angolo	Substantiv	B1
annuncio	Substantiv	B1
ansia	Substantiv	B1
ansioso	Adjektiv	B1
appassionato	Adjektiv	B1
appunto	Substantiv	B1
asilo	Substantiv	B1
aspro	Adjektiv	B1
assegno	Substantiv	B1
assolutamente	Adverb	B1
attendere	Verb	B1
attentamente	Adverb	B1
attesa	Substantiv	B1
attore	Substantiv	B1
attrice	Substantiv	B1
avaro	Adjektiv	B1
avverbio	Substantiv	B1
bagaglio	Substantiv	B1
bagnare	Verb	B1
bagnarsi	Verb	B1
bancomat	Substantiv	B1
banconota	Substantiv	B1
beh	Interjektion	B1
bilancia	Substantiv	B1
bilocale	Substantiv	B1
binario	Substantiv	B1
bisognare	Verb	B1
bocciare	Verb	B1
bollente	Adjektiv	B1
bollire	Verb	B1
breve	Adjektiv	B1
bruciarsi	Verb	B1
buttare	Verb	B1
cadere	Verb	B1
calma	Substantiv	B1
calmarsi	Verb	B1
camion	Substantiv	B1
campo	Substantiv	B1
canale	Substantiv	B1
canguro	Substantiv	B1
cantante	Substantiv	B1
capace	Adjektiv	B1
capodanno	Substantiv	B1
caricare	Verb	B1
carnevale	Substantiv	B1
cartone	Substantiv	B1
cassettiera	Substantiv	B1
causa	Substantiv	B1
cerotto	Substantiv	B1
certamente	Adverb	B1
cervello	Substantiv	B1
chiacchierare	Verb	B1
cimitero	Substantiv	B1
cioè	Konjunktion	B1
cipolla	Substantiv	B1
classico	Adjektiv	B1
cliccare	Verb	B1
cliente	Substantiv	B1
clima	Substantiv	B1
clinica	Substantiv	B1
coincidenza	Substantiv	B1
collegio	Substantiv	B1
collezionare	Verb	B1
collezione	Substantiv	B1
colloquio	Substantiv	B1
colpa	Substantiv	B1
commedia	Substantiv	B1
compagnia	Substantiv	B1
compilare	Verb	B1
complemento	Substantiv	B1
complicare	Verb	B1
comportarsi	Verb	B1
Comune	Substantiv	B1
comunicare	Verb	B1
comunicazione	Substantiv	B1
comunque	Konjunktion	B1
concorso	Substantiv	B1
condizionare	Verb	B1
condoglianza	Substantiv	B1
condominio	Substantiv	B1
confuso	Adjektiv	B1
connettersi	Verb	B1
conoscenza	Substantiv	B1
consegnare	Verb	B1
consigliare	Verb	B1
consiglio	Substantiv	B1
contante	Substantiv	B1
contattare	Verb	B1
contemporaneo	Adjektiv	B1
copia	Substantiv	B1
coraggio	Interjektion	B1
cordiale	Adjektiv	B1
cordialmente	Adverb	B1
corrente	Adjektiv	B1
costoso	Adjektiv	B1
costruire	Verb	B1
costruzione	Substantiv	B1
crepare	Verb	B1
crudo	Adjektiv	B1
cui	Pronomen	B1
cuocere	Verb	B1
cuore	Substantiv	B1
curioso	Adjektiv	B1
curriculum vitae	Substantiv	B1
dappertutto	Adverb	B1
davvero	Adverb	B1
decidere	Verb	B1
denaro	Substantiv	B1
dentista	Substantiv	B1
deprimere	Verb	B1
descrivere	Verb	B1
dialetto	Substantiv	B1
diario	Substantiv	B1
dieta	Substantiv	B1
differente	Adjektiv	B1
dipendere	Verb	B1
diploma	Substantiv	B1
diplomarsi	Verb	B1
direttamente	Adverb	B1
direzione	Substantiv	B1
discesa	Substantiv	B1
disoccupata	Adjektiv	B1
disoccupata	Substantiv	B1
disoccupato	Adjektiv	B1
disoccupato	Substantiv	B1
dispensa	Substantiv	B1
disperare	Verb	B1
distinto	Adjektiv	B1
diventare	Verb	B1
documentario	Substantiv	B1
dolore	Substantiv	B1
dopo	Präposition	B1
dopodomani	Adverb	B1
dunque	Konjunktion	B1
duomo	Substantiv	B1
durare	Verb	B1
duro	Adjektiv	B1
eccezionale	Adjektiv	B1
egoista	Adjektiv	B1
egregio	Adjektiv	B1
eh	Interjektion	B1
elettricista	Substantiv	B1
elicottero	Substantiv	B1
emergenza	Substantiv	B1
emozione	Substantiv	B1
esperienza	Substantiv	B1
esprimere	Verb	B1
estroverso	Adjektiv	B1
famoso	Adjektiv	B1
fantastico	Adjektiv	B1
farina	Substantiv	B1
favola	Substantiv	B1
felicità	Substantiv	B1
feria	Substantiv	B1
ferire	Verb	B1
ferirsi	Verb	B1
ferita	Substantiv	B1
fermare	Verb	B1
festeggiare	Verb	B1
fiction	Substantiv	B1
finale	Adjektiv	B1
finalmente	Adverb	B1
fontana	Substantiv	B1
forma	Substantiv	B1
forza	Substantiv	B1
forza	Interjektion	B1
freno	Substantiv	B1
fretta	Substantiv	B1
friggere	Verb	B1
frullatore	Substantiv	B1
fumetto	Substantiv	B1
fumo	Substantiv	B1
funzionare	Verb	B1
fuori	Präposition	B1
futuro	Substantiv	B1
gara	Substantiv	B1
gelato	Adjektiv	B1
generalmente	Adverb	B1
genere	Substantiv	B1
generoso	Adjektiv	B1
gente	Substantiv	B1
giardinaggio	Substantiv	B1
giocatore	Substantiv	B1
giocatrice	Substantiv	B1
gioia	Substantiv	B1
grammo	Substantiv	B1
grosso	Adjektiv	B1
gruppo	Substantiv	B1
guadagnare	Verb	B1
guarire	Verb	B1
guasto	Adjektiv	B1
guasto	Substantiv	B1
gusto	Substantiv	B1
idraulico	Substantiv	B1
immaginare	Verb	B1
impaziente	Adjektiv	B1
impegnare	Verb	B1
impegno	Substantiv	B1
impianto	Substantiv	B1
importare	Verb	B1
improbabile	Adjektiv	B1
improvvisamente	Adverb	B1
improvviso	Adjektiv	B1
incendio	Substantiv	B1
incidente	Substantiv	B1
incominciare	Verb	B1
incredibile	Adjektiv	B1
incrocio	Substantiv	B1
incubo	Substantiv	B1
indifferente	Adjektiv	B1
indimenticabile	Adjektiv	B1
infatti	Konjunktion	B1
infine	Adverb	B1
informare	Verb	B1
innamorarsi	Verb	B1
inoltre	Adverb	B1
insipido	Adjektiv	B1
insomma	Adverb	B1
interessarsi	Verb	B1
introverso	Adjektiv	B1
invece	Konjunktion	B1
inventare	Verb	B1
inviare	Verb	B1
istituto	Substantiv	B1
ladra	Substantiv	B1
ladro	Substantiv	B1
laurea	Substantiv	B1
laurearsi	Verb	B1
lentamente	Adverb	B1
leone	Substantiv	B1
liceo	Substantiv	B1
linea	Substantiv	B1
liquido	Adjektiv	B1
lirica	Adjektiv	B1
lirica	Substantiv	B1
locale	Substantiv	B1
lotto	Substantiv	B1
lupo	Substantiv	B1
maestra	Substantiv	B1
maestro	Substantiv	B1
maggiore	Adjektiv	B1
magnifico	Adjektiv	B1
malattia	Substantiv	B1
mancare	Verb	B1
mandare	Verb	B1
marca	Substantiv	B1
marciapiede	Substantiv	B1
master	Substantiv	B1
massimo	Adjektiv	B1
medio	Adjektiv	B1
meglio	Adjektiv	B1
mensile	Substantiv	B1
mensola	Substantiv	B1
mentre	Konjunktion	B1
meraviglioso	Adjektiv	B1
metallo	Substantiv	B1
metropoli	Substantiv	B1
migliorare	Verb	B1
migliore	Adjektiv	B1
minimo	Adjektiv	B1
minore	Adjektiv	B1
mite	Adjektiv	B1
modo	Substantiv	B1
modulo	Substantiv	B1
moneta	Substantiv	B1
monolocale	Substantiv	B1
morte	Substantiv	B1
motivo	Substantiv	B1
motore	Substantiv	B1
musicale	Adjektiv	B1
nascondere	Verb	B1
naturale	Adjektiv	B1
navigare	Verb	B1
ne	Pronominalpartikel	B1
né	Konjunktion	B1
neanche	Adverb	B1
neanche	Konjunktion	B1
necessario	Adjektiv	B1
negativo	Adjektiv	B1
nessuno	Adjektiv	B1
notizia	Substantiv	B1
novità	Substantiv	B1
obbligatorio	Adjektiv	B1
occasione	Substantiv	B1
occupare	Verb	B1
occuparsi	Verb	B1
odiare	Verb	B1
odio	Substantiv	B1
offerta	Substantiv	B1
onesto	Adjektiv	B1
opera	Substantiv	B1
opinione	Substantiv	B1
oppure	Konjunktion	B1
ordine	Substantiv	B1
orribile	Adjektiv	B1
ospitalità	Substantiv	B1
osservare	Verb	B1
ottimista	Adjektiv	B1
ottimo	Adjektiv	B1
ovale	Adjektiv	B1
paese	Substantiv	B1
parere	Substantiv	B1
partecipare	Verb	B1
particolarmente	Adverb	B1
passaggio	Substantiv	B1
passione	Substantiv	B1
pazienza	Substantiv	B1
pediatra	Substantiv	B1
pedonale	Adjektiv	B1
peggio	Adverb	B1
peggio	Adjektiv	B1
peggiorare	Verb	B1
peggiore	Adjektiv	B1
perciò	Konjunktion	B1
perfetto	Adjektiv	B1
periodo	Substantiv	B1
permesso	Substantiv	B1
però	Konjunktion	B1
pesare	Verb	B1
pessimista	Adjektiv	B1
pessimo	Adjektiv	B1
phon	Substantiv	B1
piacevole	Adjektiv	B1
piccante	Adjektiv	B1
piegare	Verb	B1
piegarsi	Verb	B1
pieno	Substantiv	B1
pillola	Substantiv	B1
pittore	Substantiv	B1
pittrice	Substantiv	B1
pittura	Substantiv	B1
piuttosto	Adverb	B1
pizzico	Substantiv	B1
plastica	Substantiv	B1
plurale	Substantiv	B1
poesia	Substantiv	B1
poeta	Substantiv	B1
poetessa	Substantiv	B1
pompiere	Substantiv	B1
pop	Substantiv	B1
pop	Adjektiv	B1
porto	Substantiv	B1
positivo	Adjektiv	B1
possibilità	Substantiv	B1
postino	Substantiv	B1
praticamente	Adverb	B1
pratico	Adjektiv	B1
precedente	Adjektiv	B1
prefisso	Substantiv	B1
pregare	Verb	B1
premere	Verb	B1
preposizione	Substantiv	B1
presentare	Verb	B1
preside	Substantiv	B1
prestare	Verb	B1
previsione	Substantiv	B1
prezzemolo	Substantiv	B1
probabile	Adjektiv	B1
prodotto	Substantiv	B1
profondo	Adjektiv	B1
promettere	Verb	B1
promuovere	Verb	B1
pronome	Substantiv	B1
pronuncia	Substantiv	B1
proporre	Verb	B1
proprio	Adverb	B1
protagonista	Substantiv	B1
pubblicità	Substantiv	B1
pulizia	Substantiv	B1
pure	Konjunktion	B1
purtroppo	Adverb	B1
quadrato	Adjektiv	B1
quadro	Adjektiv	B1
qualsiasi	Pronomen	B1
qualsiasi	Adjektiv	B1
quartiere	Substantiv	B1
questura	Substantiv	B1
quindi	Adverb	B1
quindi	Konjunktion	B1
quotidiano	Substantiv	B1
racchetta	Substantiv	B1
raccogliere	Verb	B1
raccomandata	Substantiv	B1
raccontare	Verb	B1
raramente	Adverb	B1
regista	Substantiv	B1
rendere	Verb	B1
reparto	Substantiv	B1
restituire	Verb	B1
rettangolare	Adjektiv	B1
rettore	Substantiv	B1
riassumere	Verb	B1
ricetta	Substantiv	B1
ricordo	Substantiv	B1
ringraziare	Verb	B1
riparare	Verb	B1
risultato	Substantiv	B1
ritirare	Verb	B1
riuscire	Verb	B1
rivista	Substantiv	B1
rock	Substantiv	B1
romantico	Adjektiv	B1
romanzo	Substantiv	B1
rompersi	Verb	B1
rotondo	Adjektiv	B1
rubare	Verb	B1
ruota	Substantiv	B1
sacco	Substantiv	B1
salire	Verb	B1
salita	Substantiv	B1
saltare	Verb	B1
salutare	Verb	B1
sano	Adjektiv	B1
sapore	Substantiv	B1
sbagliarsi	Verb	B1
sbucciare	Verb	B1
scaffale	Substantiv	B1
scaricare	Verb	B1
scendere	Verb	B1
schiera	Substantiv	B1
schifo	Substantiv	B1
sciopero	Substantiv	B1
sciroppo	Substantiv	B1
sconto	Substantiv	B1
scoprire	Verb	B1
scrittore	Substantiv	B1
scrittrice	Substantiv	B1
scultore	Substantiv	B1
scultrice	Substantiv	B1
scultura	Substantiv	B1
sdraiare	Verb	B1
sdraiarsi	Verb	B1
secco	Adjektiv	B1
secolo	Substantiv	B1
seguente	Adjektiv	B1
semplice	Adjektiv	B1
sennò	Konjunktion	B1
serata	Substantiv	B1
sereno	Adjektiv	B1
servire	Verb	B1
settimanale	Substantiv	B1
sfortuna	Substantiv	B1
sia	Konjunktion	B1
siccome	Konjunktion	B1
sicuramente	Adverb	B1
sito	Substantiv	B1
situazione	Substantiv	B1
smettere	Verb	B1
sms	Substantiv	B1
socievole	Adjektiv	B1
soggetto	Substantiv	B1
sognare	Verb	B1
sogno	Substantiv	B1
solido	Adjektiv	B1
soltanto	Adverb	B1
soprattutto	Adverb	B1
sottile	Adjektiv	B1
spaventare	Verb	B1
spaventoso	Adjektiv	B1
speciale	Adjektiv	B1
specialmente	Adverb	B1
spesso	Adjektiv	B1
spettabile	Adjektiv	B1
spicchio	Substantiv	B1
spostare	Verb	B1
stage	Substantiv	B1
stampare	Verb	B1
stendere	Verb	B1
stendersi	Verb	B1
stomaco	Substantiv	B1
stress	Substantiv	B1
stressare	Verb	B1
successo	Substantiv	B1
superare	Verb	B1
svolgere	Verb	B1
talk-show	Substantiv	B1
tanto	Pronomen	B1
telefilm	Substantiv	B1
telegiornale	Substantiv	B1
tenero	Adjektiv	B1
terminare	Verb	B1
termometro	Substantiv	B1
termosifone	Substantiv	B1
terribile	Adjektiv	B1
tigre	Substantiv	B1
tipo	Substantiv	B1
titolo	Substantiv	B1
tombola	Substantiv	B1
torre	Substantiv	B1
tostapane	Substantiv	B1
totale	Substantiv	B1
tradurre	Verb	B1
tragedia	Substantiv	B1
tramonto	Substantiv	B1
trasferirsi	Verb	B1
traslocare	Verb	B1
trasloco	Substantiv	B1
trasmissione	Substantiv	B1
trasparente	Adjektiv	B1
trasportare	Verb	B1
trovarsi	Verb	B1
tuttavia	Konjunktion	B1
ubriacarsi	Verb	B1
ubriaco	Adjektiv	B1
ulteriore	Adjektiv	B1
umido	Adjektiv	B1
umore	Substantiv	B1
unico	Adjektiv	B1
utilizzare	Verb	B1
vaglia	Substantiv	B1
vagone	Substantiv	B1
variabile	Adjektiv	B1
velocemente	Adverb	B1
versare	Verb	B1
verso	Präposition	B1
via	Adverb	B1
vietare	Verb	B1
vigile	Substantiv	B1
vigilessa	Substantiv	B1
villa	Substantiv	B1
villaggio	Substantiv	B1
vincere	Verb	B1
vita	Substantiv	B1
vivo	Adjektiv	B1
volentieri	Adverb	B1
abbandonare	Verb	B2
abbassare	Verb	B2
abbondante	Adjektiv	B2
abile	Adjektiv	B2
abilità	Substantiv	B2
abitazione	Substantiv	B2
abituarsi	Verb	B2
abitudine	Substantiv	B2
accadere	Verb	B2
accarezzare	Verb	B2
accelerare	Verb	B2
accettare	Verb	B2
accidenti	Interjektion	B2
accogliere	Verb	B2
accorgersi	Verb	B2
accusare	Verb	B2
adatto	Adjektiv	B2
addetta	Substantiv	B2
addetto	Substantiv	B2
adolescente	Substantiv	B2
adoperare	Verb	B2
adorare	Verb	B2
adottare	Verb	B2
affare	Substantiv	B2
affatto	Adverb	B2
affermare	Verb	B2
affermazione	Substantiv	B2
affinché	Konjunktion	B2
affrontare	Verb	B2
agio	Substantiv	B2
agricoltura	Substantiv	B2
agriturismo	Substantiv	B2
alimentazione	Substantiv	B2
allarme	Substantiv	B2
allontanarsi	Verb	B2
altrettanto	Adjektiv	B2
altrimenti	Adverb	B2
ambiente	Substantiv	B2
ammazzare	Verb	B2
ammettere	Verb	B2
amministratore	Substantiv	B2
amministratrice	Substantiv	B2
ammirare	Verb	B2
ampio	Adjektiv	B2
andarsene	Verb	B2
annullare	Verb	B2
appartenere	Verb	B2
apprezzare	Verb	B2
appunto	Adverb	B2
argomento	Substantiv	B2
arma	Substantiv	B2
armonia	Substantiv	B2
arrestare	Verb	B2
artificiale	Adjektiv	B2
artigianato	Substantiv	B2
asma	Substantiv	B2
aspettarsi	Verb	B2
aspetto	Substantiv	B2
assassina	Substantiv	B2
assassino	Substantiv	B2
assente	Adjektiv	B2
assenza	Substantiv	B2
assicurare	Verb	B2
assicurazione	Substantiv	B2
associazione	Substantiv	B2
assomigliare	Verb	B2
assumere	Verb	B2
assurdo	Adjektiv	B2
atteggiamento	Substantiv	B2
attentato	Substantiv	B2
attimo	Substantiv	B2
attività	Substantiv	B2
attraverso	Präposition	B2
augurare	Verb	B2
augurarsi	Verb	B2
aumentare	Verb	B2
aumento	Substantiv	B2
autentico	Adjektiv	B2
autore	Substantiv	B2
autrice	Substantiv	B2
avvertire	Verb	B2
avvicinarsi	Verb	B2
azienda	Substantiv	B2
azione	Substantiv	B2
base	Substantiv	B2
bastare	Verb	B2
beato	Adjektiv	B2
bellezza	Substantiv	B2
benché	Konjunktion	B2
boh	Interjektion	B2
bolletta	Substantiv	B2
bollettino	Substantiv	B2
bomba	Substantiv	B2
bonifico	Substantiv	B2
brano	Substantiv	B2
bugia	Substantiv	B2
cadavere	Substantiv	B2
calcolare	Verb	B2
cantiere	Substantiv	B2
capacità	Substantiv	B2
capitale	Substantiv	B2
capitare	Verb	B2
carabiniere	Substantiv	B2
carattere	Substantiv	B2
carcere	Substantiv	B2
carriera	Substantiv	B2
caso	Substantiv	B2
catturare	Verb	B2
cavarsela	Verb	B2
cavolo	Interjektion	B2
celibe	Adjektiv	B2
certificato	Substantiv	B2
certo	Adjektiv	B2
chissà	Adverb	B2
chiunque	Pronomen	B2
ciascuno	Pronomen	B2
cieco	Adjektiv	B2
cieco	Substantiv	B2
cima	Substantiv	B2
ciò	Pronomen	B2
citare	Verb	B2
cittadinanza	Substantiv	B2
coda	Substantiv	B2
cogliere	Verb	B2
collaboratore	Substantiv	B2
collaboratrice	Substantiv	B2
collocamento	Substantiv	B2
colpevole	Adjektiv	B2
colpevole	Substantiv	B2
combattere	Verb	B2
come	Konjunktion	B2
commentare	Verb	B2
commento	Substantiv	B2
commercio	Substantiv	B2
complesso	Adjektiv	B2
comportamento	Substantiv	B2
comprendere	Verb	B2
comunque	Adverb	B2
concentrare	Verb	B2
concentrarsi	Verb	B2
concorrenza	Substantiv	B2
concludere	Verb	B2
conclusione	Substantiv	B2
condannare	Verb	B2
condividere	Verb	B2
condizione	Substantiv	B2
conferenza	Substantiv	B2
confermare	Verb	B2
confrontare	Verb	B2
confronto	Substantiv	B2
coniugare	Verb	B2
coniuge	Substantiv	B2
conseguenza	Substantiv	B2
considerare	Verb	B2
considerazione	Substantiv	B2
consonante	Substantiv	B2
contare	Verb	B2
contatto	Substantiv	B2
contemporaneamente	Adverb	B2
continuamente	Adverb	B2
contrario	Substantiv	B2
contratto	Substantiv	B2
contro	Präposition	B2
controllare	Verb	B2
convincere	Verb	B2
convivente	Substantiv	B2
coraggio	Substantiv	B2
corrente	Substantiv	B2
cortesia	Substantiv	B2
costringere	Verb	B2
creare	Verb	B2
crescere	Verb	B2
criminale	Substantiv	B2
crisi	Substantiv	B2
criticare	Verb	B2
cronaca	Substantiv	B2
cura	Substantiv	B2
curarsi	Verb	B2
danno	Substantiv	B2
dato	Substantiv	B2
debito	Substantiv	B2
decisione	Substantiv	B2
deludere	Verb	B2
delusione	Substantiv	B2
democrazia	Substantiv	B2
denuncia	Substantiv	B2
denunciare	Verb	B2
deserto	Substantiv	B2
desiderare	Verb	B2
desiderio	Substantiv	B2
destinatario	Substantiv	B2
detestare	Verb	B2
diavolo	Substantiv	B2
dichiarare	Verb	B2
difendere	Verb	B2
difetto	Substantiv	B2
differenza	Substantiv	B2
difficoltà	Substantiv	B2
diminuire	Verb	B2
dimostrare	Verb	B2
Dio	Substantiv	B2
dipendente	Substantiv	B2
dipendenza	Substantiv	B2
dirigente	Substantiv	B2
disabile	Adjektiv	B2
discorso	Substantiv	B2
discussione	Substantiv	B2
discutere	Verb	B2
disgustoso	Adjektiv	B2
distanza	Substantiv	B2
disturbare	Verb	B2
dividere	Verb	B2
divieto	Substantiv	B2
dottorato	Substantiv	B2
dovunque	Adverb	B2
droga	Substantiv	B2
dubbio	Substantiv	B2
dubitare	Verb	B2
eccetera	Adverb	B2
eccetto	Präposition	B2
ecco	Adverb	B2
educazione	Substantiv	B2
elezione	Substantiv	B2
enorme	Adjektiv	B2
entro	Präposition	B2
epoca	Substantiv	B2
esatto	Adjektiv	B2
esatto	Adverb	B2
escludere	Verb	B2
esercito	Substantiv	B2
esistere	Verb	B2
espressione	Substantiv	B2
esterno	Adjektiv	B2
evidente	Adjektiv	B2
evidenza	Substantiv	B2
farcela	Verb	B2
fastidio	Substantiv	B2
fatica	Substantiv	B2
fede	Substantiv	B2
feriale	Adjektiv	B2
festivo	Adjektiv	B2
fidarsi	Verb	B2
fiducia	Substantiv	B2
figo	Adjektiv	B2
figura	Substantiv	B2
figurarsi	Verb	B2
fila	Substantiv	B2
finché	Konjunktion	B2
finora	Adverb	B2
finto	Adjektiv	B2
folla	Substantiv	B2
fondo	Substantiv	B2
formazione	Substantiv	B2
fornitore	Substantiv	B2
fragile	Adjektiv	B2
fregarsene	Verb	B2
frenare	Verb	B2
furto	Substantiv	B2
galera	Substantiv	B2
galleria	Substantiv	B2
ganzo	Adjektiv	B2
generazione	Substantiv	B2
gesto	Substantiv	B2
ghiacciaio	Substantiv	B2
giudice	Substantiv	B2
giustizia	Substantiv	B2
globalizzazione	Substantiv	B2
governo	Substantiv	B2
grave	Adjektiv	B2
gridare	Verb	B2
guerra	Substantiv	B2
gustare	Verb	B2
ideale	Adjektiv	B2
ideologia	Substantiv	B2
imitare	Verb	B2
immagine	Substantiv	B2
immobile	Substantiv	B2
impensabile	Adjektiv	B2
importanza	Substantiv	B2
impresa	Substantiv	B2
impressione	Substantiv	B2
includere	Verb	B2
indispensabile	Adjektiv	B2
infanzia	Substantiv	B2
inferiore	Adjektiv	B2
innanzitutto	Adverb	B2
innocente	Adjektiv	B2
inquilina	Substantiv	B2
inquilino	Substantiv	B2
inquinamento	Substantiv	B2
insistere	Verb	B2
intanto	Adverb	B2
intendere	Verb	B2
intenzione	Substantiv	B2
interesse	Substantiv	B2
interno	Adjektiv	B2
interno	Substantiv	B2
interrompere	Verb	B2
intervenire	Verb	B2
intervista	Substantiv	B2
investire	Verb	B2
invisibile	Adjektiv	B2
iscriversi	Verb	B2
iscrizione	Substantiv	B2
laggiù	Adverb	B2
lassù	Adverb	B2
lamentarsi	Verb	B2
lato	Substantiv	B2
lavorativo	Adjektiv	B2
legge	Substantiv	B2
liberare	Verb	B2
libertà	Substantiv	B2
licenziare	Verb	B2
litigare	Verb	B2
logico	Adjektiv	B2
lordo	Adjektiv	B2
magari	Interjektion	B2
mah	Interjektion	B2
maiuscola	Substantiv	B2
manager	Substantiv	B2
mancanza	Substantiv	B2
maniera	Substantiv	B2
mantenere	Verb	B2
maternità	Substantiv	B2
matto	Adjektiv	B2
maturità	Substantiv	B2
mente	Substantiv	B2
merce	Substantiv	B2
messa	Substantiv	B2
metodo	Substantiv	B2
mettercela	Verb	B2
mezzo	Substantiv	B2
militare	Adjektiv	B2
militare	Substantiv	B2
millimetro	Substantiv	B2
ministro	Substantiv	B2
minuscola	Substantiv	B2
minuscolo	Adjektiv	B2
miseria	Substantiv	B2
mittente	Substantiv	B2
moltiplicare	Verb	B2
morbido	Adjektiv	B2
mostrare	Verb	B2
movimento	Substantiv	B2
multa	Substantiv	B2
municipio	Substantiv	B2
mura	Substantiv	B2
muto	Adjektiv	B2
mutuo	Substantiv	B2
nemico	Adjektiv	B2
nemico	Substantiv	B2
nemmeno	Adverb	B2
nemmeno	Konjunktion	B2
netto	Adjektiv	B2
nonostante	Präposition	B2
nonostante	Konjunktion	B2
nubile	Adjektiv	B2
nulla	Adverb	B2
obbligare	Verb	B2
oggigiorno	Adverb	B2
ognuno	Pronomen	B2
omicidio	Substantiv	B2
onestà	Substantiv	B2
opportunità	Substantiv	B2
opportuno	Adjektiv	B2
organizzazione	Substantiv	B2
orizzontale	Adjektiv	B2
ormai	Adverb	B2
ovvio	Adjektiv	B2
pace	Substantiv	B2
paesaggio	Substantiv	B2
paga	Substantiv	B2
pagamento	Substantiv	B2
Papa	Substantiv	B2
parecchio	Adverb	B2
parecchio	Adjektiv	B2
parentesi	Substantiv	B2
parlamento	Substantiv	B2
partito	Substantiv	B2
patto	Substantiv	B2
pazzesco	Adjektiv	B2
pena	Substantiv	B2
perdonare	Verb	B2
perfino	Adverb	B2
pericoloso	Adjektiv	B2
personaggio	Substantiv	B2
personale	Adjektiv	B2
personale	Substantiv	B2
personalità	Substantiv	B2
personalmente	Adverb	B2
pietà	Substantiv	B2
pistola	Substantiv	B2
poiché	Konjunktion	B2
politica	Substantiv	B2
politico	Adjektiv	B2
polizza	Substantiv	B2
porco	Adjektiv	B2
porgere	Verb	B2
possedere	Verb	B2
povertà	Substantiv	B2
precedenza	Substantiv	B2
prendersela	Verb	B2
preoccupazione	Substantiv	B2
presentazione	Substantiv	B2
presente	Adjektiv	B2
presenza	Substantiv	B2
presidente	Substantiv	B2
presso	Adverb	B2
prestito	Substantiv	B2
prete	Substantiv	B2
prigione	Substantiv	B2
principale	Substantiv	B2
privato	Adjektiv	B2
probabilità	Substantiv	B2
processo	Substantiv	B2
progetto	Substantiv	B2
proibire	Verb	B2
proposito	Substantiv	B2
proprio	Adjektiv	B2
proteggere	Verb	B2
Provincia	Substantiv	B2
pubblico	Adjektiv	B2
purché	Konjunktion	B2
pure	Adverb	B2
puro	Adjektiv	B2
puzza	Substantiv	B2
puzzare	Verb	B2
qualità	Substantiv	B2
qualunque	Adjektiv	B2
questione	Substantiv	B2
quintale	Substantiv	B2
raccomandarsi	Verb	B2
raggiungere	Verb	B2
rallentare	Verb	B2
rapina	Substantiv	B2
rapporto	Substantiv	B2
rata	Substantiv	B2
reagire	Verb	B2
realizzare	Verb	B2
realtà	Substantiv	B2
reclamo	Substantiv	B2
Regione	Substantiv	B2
regola	Substantiv	B2
relazione	Substantiv	B2
religioso	Adjektiv	B2
repubblica	Substantiv	B2
residenza	Substantiv	B2
responsabile	Adjektiv	B2
responsabile	Substantiv	B2
responsabilità	Substantiv	B2
ricchezza	Substantiv	B2
ricerca	Substantiv	B2
ricevuta	Substantiv	B2
riconoscere	Verb	B2
ridicolo	Adjektiv	B2
riferire	Verb	B2
riferirsi	Verb	B2
rifiutare	Verb	B2
riflettere	Verb	B2
riguardare	Verb	B2
rimettersi	Verb	B2
rinunciare	Verb	B2
riprendere	Verb	B2
riprendersi	Verb	B2
rischioso	Adjektiv	B2
riscontro	Substantiv	B2
risolvere	Verb	B2
risparmiare	Verb	B2
rispettare	Verb	B2
rispetto	Substantiv	B2
roba	Substantiv	B2
rotatoria	Substantiv	B2
ruvido	Adjektiv	B2
saggio	Substantiv	B2
salvare	Verb	B2
santo	Adjektiv	B2
santo	Substantiv	B2
scherzare	Verb	B2
sconfiggere	Verb	B2
scopo	Substantiv	B2
scorretto	Adjektiv	B2
scusa	Substantiv	B2
sé	Pronomen	B2
sebbene	Konjunktion	B2
sede	Substantiv	B2
seguito	Substantiv	B2
senato	Substantiv	B2
sensazione	Substantiv	B2
senso	Substantiv	B2
sentimento	Substantiv	B2
servizio	Substantiv	B2
sesso	Substantiv	B2
sfruttare	Verb	B2
sicurezza	Substantiv	B2
significato	Substantiv	B2
sillaba	Substantiv	B2
sindacato	Substantiv	B2
sindaco	Substantiv	B2
sistema	Substantiv	B2
sociale	Adjektiv	B2
società	Substantiv	B2
socia	Substantiv	B2
socio	Substantiv	B2
soddisfatto	Adjektiv	B2
soffrire	Verb	B2
soldatessa	Substantiv	B2
soldato	Substantiv	B2
solitudine	Substantiv	B2
sollecito	Adjektiv	B2
soluzione	Substantiv	B2
somma	Substantiv	B2
sopravvivere	Verb	B2
sordo	Adjektiv	B2
sospendere	Verb	B2
sottolineare	Verb	B2
sottrarre	Verb	B2
sparare	Verb	B2
spazio	Substantiv	B2
specializzarsi	Verb	B2
specializzazione	Substantiv	B2
spiegarsi	Verb	B2
statale	Adjektiv	B2
stato	Substantiv	B2
stesso	Pronomen	B2
stile	Substantiv	B2
stipendio	Substantiv	B2
suora	Substantiv	B2
superiore	Adjektiv	B2
svantaggio	Substantiv	B2
svegliare	Verb	B2
sviluppare	Verb	B2
sviluppo	Substantiv	B2
tale	Adjektiv	B2
talvolta	Adverb	B2
tariffa	Substantiv	B2
tassa	Substantiv	B2
tavola	Substantiv	B2
tecnologia	Substantiv	B2
telegramma	Substantiv	B2
temere	Verb	B2
tensione	Substantiv	B2
teoria	Substantiv	B2
terapia	Substantiv	B2
terrorismo	Substantiv	B2
terrorizzare	Verb	B2
testo	Substantiv	B2
tipico	Adjektiv	B2
tonnellata	Substantiv	B2
torto	Substantiv	B2
tradizionale	Adjektiv	B2
tranquillità	Substantiv	B2
trasformare	Verb	B2
trattare	Verb	B2
tratto	Substantiv	B2
tribunale	Substantiv	B2
turismo	Substantiv	B2
uccidere	Verb	B2
uffa	Interjektion	B2
un	Pronomen	B2
una	Pronomen	B2
uno	Pronomen	B2
urgente	Adjektiv	B2
valere	Verb	B2
valore	Substantiv	B2
vantaggio	Substantiv	B2
vario	Adjektiv	B2
vegetariano	Adjektiv	B2
velocità	Substantiv	B2
vergognarsi	Verb	B2
verità	Substantiv	B2
verticale	Adjektiv	B2
violenza	Substantiv	B2
virgoletta	Substantiv	B2
viso	Substantiv	B2
vista	Substantiv	B2
vocale	Substantiv	B2
volontà	Substantiv	B2
votare	Verb	B2

