carbonaro	ADJ
consiglio	NOM
visitatore	NOM
irlandese	ADJ
grigliata	NOM
compilare	VER:infi
superiore	ADJ
gara	NOM
stand	NOM
dea	NOM
costume	NOM
funzionamento	NOM
ripieno	ADJ
abile	ADJ
teatrale	ADJ
russo	ADJ
partecipare	VER:pper
finanziamento	NOM
contenere	VER:infi
informare	VER:pres
uso	NOM
discutere	VER:pres
sanità	NOM
attore	NOM
tiramisù	NOM
vestire	VER:pres
decidere	VER:infi
due	ADJ
stagione	NOM
curatore	NOM
biologico	ADJ
costruzione	NOM
salto	NOM
controllo	NOM
congresso	NOM
spina	NOM
marinaio	NOM
interesse	NOM
denominare	VER:pper
mantenere	VER:infi
realizzare	VER:pper
estivo	ADJ
era	VER
cotechino	NOM
sostenere	VER:pres
rivoluzione	NOM
recente	ADJ
venditore	NOM
ideale	ADJ
ordinario	ADJ
rispettare	VER:infi
casella	NOM
sicuramente	ADV
ampio	ADJ
ragù	NOM
costituzione	NOM
accadere	VER:infi
portale	NOM
merluzzo	NOM
ritenere	VER:pres
mestiere	NOM
sposato	ADJ
nido	NOM
vietare	VER:pper
contatto	NOM
rivista	NOM
universitario	ADJ
appassionare	VER:pper
dina	NP
viso	NOM
infatti	ADV
esaminare	VER:pres
contare	VER:infi
candidato	NOM
pesticida	NOM
questione	NOM
duemila	ADJ
ammettere	VER:infi
comunque	ADV
cieco	ADJ
approfittare	VER:geru
contare	VER:remo
trasferire	VER:pres
privato	ADJ
litigare	VER:infi
spedizione	NOM
novanta	ADJ
brevettare	VER:impe
modo	NOM
cento	ADJ
realtà	NOM
aumentare	VER:infi
regina	NOM
ombra	NOM
incontentabile	ADJ
osservare	VER:infi
persino	ADV
realizzare	VER:pres
carboidrato	NOM
intervistato	NOM
diventare	VER:infi
progettare	VER:pres
apparire	VER:impf
affatto	ADV
vario	ADJ
tortiglione	NOM
sedere	VER:pper
oroscopo	NOM
seguito	ADJ
acquisire	VER:infi
fuggire	VER:pper
trattare	VER:pres
latino	NOM
intuire	VER:pper
talento	NOM
riunire	VER:remo
finalista	NOM
difficoltà	NOM
integro	ADJ
smettere	VER:pper
moneta	NOM
arrotolato	ADJ
almeno	ADV
abbattere	VER:pres
chiacchierare	VER:pres
avvertire	VER:pres
aggiungere	VER:pres
yogurt	NOM
menzogna	NOM
edificio	NOM
scientifico	ADJ
svolgere	VER:pper
innamorato	ADJ
comunicazione	NOM
applicazione	NOM
rappresentazione	NOM
consigliare	VER:infi
online	ADJ
farfalla	NOM
decollare	VER:impe
addirittura	ADV
vulcano	NOM
sistema	NOM
elettronico	ADJ
modulo	NOM
assicurato	ADJ
veterinario	NOM
scannerizzare	VER:infi
apprendistato	NOM
arrivato	ADJ
colpire	VER:pper
voto	NOM
parziale	ADJ
segreto	NOM
carattere	NOM
cittadino	NOM
legge	NOM
evoluzione	NOM
servire	VER:pres
successivo	ADJ
permettere	VER:pper
senato	NOM
genere	NOM
ammalare	VER:infi
obbligo	NOM
rifiutare	VER:pres
capitare	VER:infi
continuo	ADJ
fermare	VER:pper
partecipare	VER:pres
nascondino	NOM
presentare	VER:pper
lamentare	VER:pper
gola	NOM
continente	NOM
porcino	ADJ
rispetto	NOM
breve	ADJ
ottimo	NOM
risultato	NOM
vinto	ADJ
prevendita	NOM
saio	NOM
assistere	VER:infi
appassionare	VER:pres
duramente	ADV
risultare	VER:remo
architetto	NOM
navigazione	NOM
confrontare	VER:cpre
ampliamento	NOM
rallegrare	VER:pper
tecnica	NOM
interessare	VER:pres
food	NOM
ferragosto	NOM
ufficiale	ADJ
lato	NOM
riguardare	VER:pres
vespa	NOM
autorevolezza	NOM
specie	NOM
adolescente	NOM
conoscente	NOM
fermamente	ADV
scolastico	ADJ
inevitabile	ADJ
osteria	NOM
intervenire	VER:pres
sito	ADJ
fondare	VER:pper
ovviamente	ADV
foto	NOM
smarrimento	NOM
scheda	NOM
svolgere	VER:pres
comitato	NOM
contenere	VER:pres
studioso	ADJ
deputato	NOM
dichiarazione	NOM
menu	NOM
pesare	VER:pres
scambiare	VER:infi
ammalato	ADJ
volo	NOM
ubriaco	ADJ
raggiungere	VER:infi
obiettivo	NOM
comodamente	ADV
dedicare	VER:infi
ignorare	VER:pper
riuscire	VER:pper
perfetto	ADJ
terminare	VER:pper
recensione	NOM
nascondere	VER:infi
grotta	NOM
soddisfare	VER:pper
iscrivere	VER:infi
opera	NOM
ordine	NOM
rischiare	VER:infi
repubblica	NOM
targa	NOM
cortometraggio	NOM
produrre	VER:pper
entrambi	ADJ
emozionare	VER:pper
esperto	ADJ
pubblico	ADJ
de	NPR
peso	NOM
impiegare	VER:infi
implorare	VER:remo
assicurare	VER:pres
evento	NOM
disponibile	ADJ
ospitare	VER:pres
toscano	ADJ
raccontare	VER:pres
folle	ADJ
filmato	NOM
paese	NOM
fritto	ADJ
sintomo	NOM
importare	VER:pres
grosso	ADJ
compagnia	NOM
racconto	NOM
amato	ADJ
sovrano	NOM
esagerare	VER:infi
semestre	NOM
lettore	NOM
milione	NOM
prevenire	VER:infi
valore	NOM
direzione	NOM
altezza	NOM
interrompere	VER:pres
usato	ADJ
innamorare	VER:pres
contratto	NOM
fruttivendolo	NOM
ricerca	NOM
ricostruire	VER:pres
colonizzazione	NOM
associazione	NOM
gestire	VER:infi
cipolla	NOM
comunicare	VER:pres
vendita	NOM
scadere	VER:infi
castello	NOM
poverino	ADJ
criticare	VER:pper
cantante	NOM
meraviglia	NOM
influenza	NOM
trucco	NOM
trasferire	VER:infi
capace	ADJ
discutere	VER:geru
temere	VER:pres
fondere	VER:cpre
cinque	ADJ
gareggiare	VER:infi
politica	NOM
sostituire	VER:infi
strumento	NOM
fertilizzante	NOM
commissione	NOM
informatico	NOM
archeologico	ADJ
permettere	VER:pres
termine	NOM
ciliegio	NOM
contrario	NOM
gestire	VER:impf
adorare	VER:pres
agricoltore	NOM
trasformazione	NOM
nascondere	VER:pres
pancetta	NOM
adolescente	ADJ
circostanza	NOM
magico	ADJ
weekend	NOM
ospitare	VER:pper
ridotto	ADJ
specializzato	ADJ
antichità	NOM
vivo	NOM
invasione	NOM
passione	NOM
decisione	NOM
cambiamento	NOM
emigrare	VER:pres
somma	NOM
tradizionale	ADJ
angoscia	NOM
tipo	NOM
mandare	VER:infi
panna	NOM
allestimento	NOM
salutare	ADJ
intervista	NOM
caso	NOM
usato	NOM
particolare	ADJ
utente	NOM
approfondimento	NOM
commento	NOM
danza	NOM
pigrizia	NOM
coltivare	VER:pper
disporre	VER:pper
rischio	NOM
mancare	VER:cpre
trattoria	NOM
comportare	VER:impe
passo	NOM
raggiungere	VER:pres
trasferimento	NOM
attivare	VER:infi
viale	NOM
naturale	ADJ
scorrere	VER:pper
abbigliamento	NOM
ala	NOM
speciale	ADJ
però	ADV
trasmettere	VER:infi
bastare	VER:pres
dichiarare	VER:pper
comportare	VER:infi
vitamina	NOM
innamorare	VER:infi
concedere	VER:pres
dettaglio	NOM
scaricabile	ADJ
giurisprudenza	NOM
vita	NOM
gratuitamente	ADV
accorgere	VER:pper
mediocre	ADJ
utilizzare	VER:pres
europeo	ADJ
innamorato	NOM
stupire	VER:pper
settanta	ADJ
giudizio	NOM
contestare	VER:remo
laurea	NOM
stato	NOM
affidare	VER:infi
altra	ADJ
ormai	ADV
politico	ADJ
influenzare	VER:pres
incantevole	ADJ
colui	PRO:pers
somigliare	VER:pres
liceo	NOM
filo	NOM
perfettamente	ADV
fungo	NOM
conosciuto	ADJ
evitare	VER:infi
invece	ADV
preferito	ADJ
telegrafo	NOM
davvero	ADV
ramo	NOM
legato	ADJ
impegnare	VER:pper
sottolineatura	NOM
cassetto	NOM
lira	NOM
assumere	VER:infi
mite	ADJ
ammettere	VER:pres
milanese	ADJ
colpito	ADJ
banconota	NOM
restante	ADJ
servizio	NOM
partecipare	VER:infi
festeggiare	VER:infi
bocciare	VER:pper
misto	ADJ
rappresentare	VER:pres
uso	ADJ
svolgere	VER:infi
pubblicare	VER:pres
collaborazione	NOM
alberato	ADJ
economico	ADJ
spagnolo	ADJ
ultimamente	ADV
esibizione	NOM
colle	NOM
quattro	ADJ
partecipazione	NOM
purtroppo	ADV
intervistare	VER:futu
fondale	NOM
siberiano	ADJ
magnifico	ADJ
foro	NPR
americano	ADJ
condividere	VER:pres
migliore	ADJ
nascondere	VER:remo
informare	VER:infi
trionfo	NOM
necessario	ADJ
durata	NOM
disturbo	NOM
invidia	NOM
azienda	NOM
impegnativo	ADJ
rimborsare	VER:pres
gente	NOM
immagine	NOM
bruciare	VER:infi
aurora	NPR
vincitore	NOM
affascinante	ADJ
cerimonia	NOM
leggibile	ADJ
oggigiorno	ADV
stipendio	NOM
gamberoni	NOM
raccontare	VER:cpre
libertà	NOM
attività	NOM
invio	NOM
bisognare	VER:pres
risparmiare	VER:infi
dandy	NOM
classificare	VER:pper
minorenne	ADJ
originale	NOM
facilmente	ADV
scena	NOM
creare	VER:pper
gratuito	ADJ
impresa	NOM
incrocio	NOM
fermare	VER:infi
pietra	NOM
aperto	ADJ
sms	NOM
dedurre	VER:infi
malessere	NOM
destinatario	NOM
copia	NOM
fastidio	NOM
proporre	VER:remo
psicologo	NOM
soprattutto	ADV
vietare	ADJ
costoso	ADJ
immaginare	VER:infi
casolare	NOM
coppa	NOM
proporre	VER:cpre
comunicare	VER:impf
direttamente	ADV
tema	NOM
terzo	ADJ
coprire	VER:pres
discutere	VER:impf
ritenuta	NOM
fiscale	ADJ
egoismo	NOM
occasione	NOM
aumento	NOM
telecamera	NOM
scritta	NOM
vincitore	ADJ
vivace	ADJ
condividere	VER:infi
chiuso	ADJ
vaccino	NOM
britannico	ADJ
alcun|alcune	PRO:indef
follia	NOM
stabilimento	NOM
decidere	VER:pper
scherzare	VER:pper
bilancia	NOM
emigrare	VER:pper
risultare	VER:pper
occupare	VER:pres
desiderio	NOM
curiosità	NOM
orecchino	NOM
manifesto	ADJ
dio	NOM
protestare	VER:pres
salmone	NOM
agitare	VER:impf
ricetta	NOM
acquisto	NOM
baseball	NOM
semplice	ADJ
video	ADJ
chat	NOM
manuale	ADJ
dolore	NOM
quaranta	ADJ
consumare	VER:pres
appoggio	NOM
avvocato	NOM
rapporto	NOM
verità	NOM
edizione	NOM
attaccare	VER:pres
gestire	VER:pres
cuoco	NOM
tre	ADJ
pubblicato	ADJ
allegare	VER:infi
scappare	VER:pres
copertina	NOM
cera	NOM
foresta	NOM
profilo	NOM
consegnare	VER:infi
modifica	NOM
presente	ADJ
ammirare	VER:infi
severamente	ADV
commerciale	ADJ
adatto	ADJ
voluttà	NOM
amicizia	NOM
successivamente	ADV
olimpico	ADJ
dubbio	NOM
aggiungere	VER:impf
vegetariano	ADJ
pari	ADJ
riprendere	VER:pper
intraprendere	VER:infi
emozionante	ADJ
anni	NOM
premiare	VER:pres
rendere	VER:pres
agricoltura	NOM
balletto	NOM
confortevole	ADJ
offerta	NOM
stile	NOM
apatia	NOM
mostro	NOM
dovunque	ADV
vantare	VER:pres
promettere	VER:infi
raffigurare	VER:pper
miglior	ADJ
crescita	NOM
sarta	NOM
superare	VER:pper
sei	ADJ
laboratorio	NOM
olimpiade	NOM
cinematografico	ADJ
tradizione	NOM
assicurare	VER:pper
rubrica	NOM
scaricare	VER:infi
ricordo	NOM
mandare	VER:pres
trasporto	NOM
salire	VER:infi
evitare	VER:pres
crescere	VER:pres
raccontare	VER:pper
fagiolo	NOM
costruire	VER:pres
manifestazione	NOM
chiunque	PRO:indef
esprimere	VER:infi
interno	NOM
curioso	ADJ
compilare	VER:pper
dibattito	NOM
trasmettere	VER:pper
ruolo	NOM
registrare	VER:infi
bozza	NOM
garanzia	NOM
ministro	NOM
medio	ADJ
alunno	NOM
profumeria	NOM
percorso	NOM
comportamento	NOM
tecnologia	NOM
finalista	ADJ
negare	VER:pres
qualità	NOM
eros	NPR
educativo	ADJ
cristallino	ADJ
affrontare	VER:infi
raccomandata	NOM
interessare	VER:impf
crisi	NOM
climatico	ADJ
dimostrare	VER:infi
modello	NOM
settimo	ADJ
incontro	NOM
nascondiglio	NOM
categoria	NOM
svegliare	VER:pres
accettare	VER:remo
promuovere	VER:pres
invenzione	NOM
continuamente	ADV
scoprire	VER:pper
iniziativa	NOM
iscrizione	NOM
regola	NOM
romanzo	NOM
argomento	NOM
durare	VER:pper
festival	NOM
futuro	NOM
mercatino	NOM
consegna	NOM
teologia	NOM
tavola	NOM
delicato	ADJ
vibrare	VER:infi
grido	NOM
paesaggistico	ADJ
opinione	NOM
straordinario	ADJ
colpa	NOM
mente	NOM
determinato	ADJ
definire	VER:pper
dieta	NOM
eterno	ADJ
fede	NOM
affascinare	VER:pper
progetto	NOM
pentire	VER:pres
goccia	NOM
venti	ADJ
entusiasmo	NOM
risalire	VER:ppre
accurato	ADJ
partecipante	NOM
salpa	NOM
statua	NOM
socio	NOM
perdita	NOM
allegria	NOM
ciò	PRO:demo
epoca	NOM
premio	NOM
dinamico	ADJ
salsiccia	NOM
ciak	NOM
limitare	VER:pres
forza	NOM
psiche	NOM
disturbare	VER:infi
iscrivere	ADJ
scorretto	ADJ
specificare	VER:infi
pagamento	NOM
atleta	NOM
abilità	NOM
incidente	NOM
discolpare	VER:infi
guarire	VER:pres
inventare	VER:remo
ricercatore	NOM
scoprire	VER:remo
ritirare	VER:infi
danneggiare	VER:infi
cura	NOM
altitudine	NOM
assumere	VER:pres
oltre	ADV
riuscire	VER:pres
arcobaleno	NOM
certamente	ADV
segnale	NOM
scadere	VER:pres
causa	NOM
shopping	NOM
rivolgere	VER:infi
ottenere	VER:pper
link	NOM
rilasciare	VER:infi
sé	NOM
diffuso	ADJ
divenire	VER:remo
famoso	ADJ
nemmeno	ADV
corsa	NOM
rilassare	VER:infi
motivo	NOM
prodotto	NOM
concorso	NOM
sentimento	NOM
codardia	NOM
prelibatezza	NOM
cespuglio	NOM
comparire	VER:infi
folata	NOM
sognare	VER:pres
sopracciglio	NOM
cattiveria	NOM
gran	ADJ
grammo	NOM
ospitare	VER:infi
apertura	ADJ
capitale	NOM
candela	NOM
poster	NOM
fronda	NOM
metodo	NOM
completamente	ADV
bambino 	NOM
rimborso	NOM
infine	ADV
innamorare	VER:pper
udire	VER:remo
inviare	VER:infi
regolare	ADJ
decidere	VER:pres
inviare	VER:impf
preparativo	NOM
denaro	NOM
allenare	VER:pper
permettere	VER:infi
video	NOM
maniera	NOM
spaventare	VER:infi
riuscire	VER:impf
sano	ADJ
richiesta	NOM
tirocinio	NOM
disperazione	NOM
casuale	ADJ
giuria	NOM
faticare	VER:pres
produzione	NOM
cadere	VER:infi
sciogliere	VER:pres
trasferire	VER:pper
fast	ADJ
condizione	NOM
inventare	VER:pper
contributo	NOM
influenzare	VER:infi
obbligatorio	ADJ
cuoca	NOM
arrostito	ADJ
astronomia	NOM
nazionale	ADJ
macinato	ADJ
serenamente	ADV
dignitoso	ADJ
tragedia	NOM
smettere	VER:pres
diventare	VER:pper
massimo	NOM
effetto	NOM
inadempimento	NOM
fa	ADV
comprensibile	ADJ
vincere	VER:pres
proiezione	NOM
mappa	NOM
smarrire	VER:pper
fermare	VER:pres
rischiare	VER:pres
governo	NOM
brillante	ADJ
cima	NOM
servire	VER:pper
salutare	VER:pres
fondo	NOM
diffondere	VER:infi
quindi	ADV
rispetto	ADV
superbia	NOM
intervistare	VER:pper
liberare	VER:infi
limite	NOM
disposizione	NOM
coniuge	NOM
steccato	NOM
affermare	VER:pres
fisica	NOM
possibilità	NOM
finalmente	ADV
cliente	NOM
severo	ADJ
proprio	ADV
disegno	NOM
base	NOM
mostrare	VER:pres
occupato	ADJ
fisico	ADJ
canale	NOM
ognuna	PRO:indef
scenografia	NOM
allievo	NOM
noia	NOM
apprezzare	VER:pper
cartaceo	ADJ
formato	NOM
generosità	NOM
esposto	ADJ
avvenire	VER:infi
utilizzare	VER:infi
perfetto	NOM
dimenticato	ADJ
diventare	VER:cpre
orecchie	NOM
ecc	ADV
anteprima	NOM
gareggiare	VER:pper
comunicare	VER:infi
comportare	VER:pres
nessun	ADJ
critico	NOM
alzare	VER:remo
radiotelegrafia	NOM
principale	ADJ
particolare	NOM
sbagliato	ADJ
scorgere	VER:remp
zoo	NOM
culturale	ADJ
istituzione	NOM
trasformare	VER:infi
convincere	VER:infi
avvicinare	VER:pres
invidioso	ADJ
diritto	NOM
assicurazione	NOM
ottimo	ADJ
soffrire	VER:infi
sciocco	ADJ
rotondo	ADJ
arduo	ADJ
inglese	NOM
ne	ADV
parere	NOM
presentazione	NOM
svedese	ADJ
scusa	NOM
sito	NOM
spalla	NOM
buon	ADJ
riuscire	VER:remo
svolgimento	NOM
paternità	NOM
collezione	NOM
secolo	NOM
oblio	NOM
concentrare	VER:infi
entrambi	PRO:indef
bruciare	VER:pres
cerca	NOM
bellezza	NOM
mortale	ADJ
tour	NOM
scendere	VER:pres
fantasia	NOM
dieci	ADJ
improvviso	ADJ
romano	ADJ
ferire	VER:pper
ingresso	NOM
vincere	VER:pper
d’estate	VER:impe
pubblicizzare	VER:infi
area	NOM
movimento	NOM
inizialmente	ADV
super	NPR
decorare	VER:pper
copiare	VER:infi
raggio	NOM
lettura	NOM
sugo	NOM
perdono	NOM
trasmissione	NOM
considerevole	ADJ
disporre	VER:pres
intero	ADJ
massimo	ADJ
totale	ADJ
conseguenza	NOM
seguito	NOM
docente	NOM
fattore	NOM
sogno	NOM
minore	ADJ
diventare	VER:pres
apertura	NOM
biscotto	NOM
rivolgere	VER:pres
informatico	ADJ
maggiore	ADJ
presentare	VER:infi
inglese	ADJ
allegato	ADJ
diffondere	VER:pper
attribuire	VER:infi
ripresa	NOM
coinvolgere	VER:infi
rovinare	VER:infi
intervistare	VER:infi
capacità	NOM
timidezza	NOM
perfino	ADV
accettare	VER:pres
saporito	ADJ
ventilato	ADJ
costruire	VER:pper
meraviglioso	ADJ
re	NOM
neanche	ADV
riconoscere	VER:cpre
gentilezza	NOM
smarrito	ADJ
generale	NOM
divertire	VER:pres
straordinario	NOM
alzare	VER:infi
avviso	NOM
campionato	NOM
oceano	NOM
test	NOM
navigare	VER:geru
numeroso	ADJ
avvicinare	VER:infi
proibire	VER:pper
materiale	ADJ
riadattare	VER:pper
paesaggio	NOM
glutine	NOM
consigliare	VER:pres
ingrediente	NOM
appassionato	ADJ
proprio	ADJ
personaggio	NOM
società	NOM
scoprire	VER:pres
ampliare	VER:infi
lusso	NOM
appassionare	VER:infi
inoltre	ADV
duro	ADJ
caloria	NOM
euforia	NOM
socia	NOM
cui	PRO:rela
pessimo	ADJ
cittadinanza	NOM
presentare	VER:pres
preoccupare	VER:infi
modalità	NOM
boutique	NOM
trenta	ADJ
