modello	NOM
spaventare	VER:infi
emozionare	VER:pper
fantasia	NOM
comunque	ADV
limitare	VER:pres
metodo	NOM
contestare	VER:remo
re	NOM
campionato	NOM
avvertire	VER:pres
integro	ADJ
ripieno	ADJ
scolastico	ADJ
sistema	NOM
effetto	NOM
risparmiare	VER:infi
motivo	NOM
dettaglio	NOM
dina	NP
ruolo	NOM
colle	NOM
somigliare	VER:pres
comportare	VER:impe
perdita	NOM
bambino 	NOM
abbattere	VER:pres
servire	VER:pres
paesaggistico	ADJ
sintomo	NOM
edificio	NOM
raccomandata	NOM
scenografia	NOM
arrotolato	ADJ
fisico	ADJ
informare	VER:infi
naturale	ADJ
tipo	NOM
de	NPR
diritto	NOM
lettore	NOM
pessimo	ADJ
balletto	NOM
disporre	VER:pres
consegnare	VER:infi
ammirare	VER:infi
navigare	VER:geru
infine	ADV
poverino	ADJ
salpare	VER
abilità	NOM
apprezzare	VER:pper
evento	NOM
ormai	ADV
vivace	ADJ
vincere	VER:pres
compilare	VER:pper
ufficiale	ADJ
circostanza	NOM
facilmente	ADV
attore	NOM
permettere	VER:infi
breve	ADJ
rilasciare	VER:infi
promuovere	VER:pres
sbagliato	ADJ
limite	NOM
romanzo	NOM
grosso	ADJ
comunicazione	NOM
discutere	VER:impf
opinione	NOM
incantevole	ADJ
profilo	NOM
successivamente	ADV
banconota	NOM
dieci	ADJ
approfittare	VER:geru
rimborso	NOM
volo	NOM
principale	ADJ
dandy	NOM
genere	NOM
sugo	NOM
scaricare	VER:infi
protestare	VER:pres
emozionante	ADJ
avviso	NOM
usato	ADJ
strumento	NOM
tradizione	NOM
aggiungere	VER:pres
preparativo	NOM
agricoltore	NOM
ordinario	ADJ
viale	NOM
appoggio	NOM
manifesto	NOM
premio	NOM
colonizzazione	NOM
liberare	VER:infi
ospitare	VER:infi
scadere	VER:infi
decorare	VER:pper
trucco	NOM
mandare	VER:pres
iscrizione	NOM
approfondimento	NOM
siberiano	ADJ
perfettamente	ADV
gestire	VER:impf
boutique	NOM
marinaio	NOM
funzionamento	NOM
smarrire	VER:pper
segreto	NOM
specie	NOM
coniuge	NOM
sostituire	VER:infi
svolgere	VER:pres
medio	ADJ
invenzione	NOM
comprensibile	ADJ
specificare	VER:infi
lusso	NOM
sogno	NOM
navigazione	NOM
finalmente	ADV
settimo	ADJ
allestimento	NOM
adolescente	ADJ
agitare	VER:impf
rivolgere	VER:pres
foresta	NOM
prevendita	NOM
trasmettere	VER:pper
gola	NOM
rispettare	VER:infi
edizione	NOM
conseguenza	NOM
cotechino	NOM
ingresso	NOM
prelibatezza	NOM
uso	NOM
politica	NOM
infatti	ADV
ampliare	VER:infi
svolgimento	NOM
affascinante	ADJ
eterno	ADJ
comunicare	VER:impf
duro	ADJ
rivista	NOM
risultato	NOM
diffondere	VER:pper
soffrire	VER:infi
telegrafo	NOM
fermare	VER:pres
concedere	VER:pres
affidare	VER:infi
comitato	NOM
continuamente	ADV
impegnativo	ADJ
serenamente	ADV
deputato	NOM
allenare	VER:pper
culturale	ADJ
sovrano	NOM
intervistare	VER:futu
cinematografico	ADJ
mercatino	NOM
coinvolgere	VER:infi
ospitare	VER:pper
tema	NOM
totale	ADJ
fagiolo	NOM
scherzare	VER:pper
carattere	NOM
mandare	VER:infi
dedicare	VER:infi
trasmissione	NOM
inglese	ADJ
stato	NOM
consigliare	VER:pres
appassionare	VER:infi
bisognare	VER:pres
discutere	VER:pres
legato	ADJ
proprio	ADJ
attribuire	VER:infi
ridotto	ADJ
moneta	NOM
utente	NOM
società	NOM
contributo	NOM
pesare	VER:pres
rischiare	VER:pres
categoria	NOM
pubblicare	VER:pres
determinato	ADJ
vietato	ADJ
meraviglioso	ADJ
vario	ADJ
raggiungere	VER:pres
vestire	VER:pres
sms	NOM
gente	NOM
presentare	VER:infi
ammalato	ADJ
incidente	NOM
rimborsare	VER:pres
biscotto	NOM
inviare	VER:infi
cambiamento	NOM
ottimo	ADJ
consumare	VER:pres
vietare	VER:pper
ecc	ADV
senato	NOM
malessere	NOM
invidioso	ADJ
desiderio	NOM
somma	NOM
intervista	NOM
decidere	VER:pper
rischio	NOM
spagnolo	ADJ
superare	VER:pper
vantare	VER:pres
nemmeno	ADV
gareggiare	VER:infi
commissione	NOM
stupire	VER:pper
fa	ADV
cura	NOM
comunicare	VER:infi
foto	NOM
inglese	NOM
dinamico	ADJ
tecnologia	NOM
interrompere	VER:pres
ammettere	VER:infi
costituzione	NOM
impresa	NOM
intervistare	VER:pper
costruire	VER:pres
cipolla	NOM
affascinare	VER:pper
innamorare	VER:pper
due	ADJ
tradizionale	ADJ
quaranta	ADJ
rallegrare	VER:pper
disponibile	ADJ
racconto	NOM
partecipare	VER:pres
svolgere	VER:infi
adolescente	NOM
pari	ADJ
modalità	NOM
straordinario	NOM
finalista	ADJ
questione	NOM
ultimamente	ADV
contatto	NOM
accurato	ADJ
tirocinio	NOM
obiettivo	NOM
osteria	NOM
cuoco	NOM
usato	NOM
litigare	VER:infi
duemila	ADJ
trasferimento	NOM
perfetto	NOM
trattoria	NOM
mancare	VER:cpre
critico	NOM
ingrediente	NOM
servizio	NOM
affermare	VER:pres
superiore	ADJ
avvocato	NOM
recensione	NOM
zoo	NOM
scoprire	VER:pres
stabilimento	NOM
altitudine	NOM
ampio	ADJ
magico	ADJ
adorare	VER:pres
modulo	NOM
svolgere	VER:pper
finanziamento	NOM
crescere	VER:pres
cortometraggio	NOM
comunicare	VER:pres
portale	NOM
raccontare	VER:pres
decisione	NOM
sottolineatura	NOM
movimento	NOM
sei	ADJ
tragedia	NOM
preferito	ADJ
giuria	NOM
massimo	NOM
vincitore	NOM
neanche	ADV
condividere	VER:pres
smarrimento	NOM
caso	NOM
mite	ADJ
esagerare	VER:infi
trasmettere	VER:infi
disperazione	NOM
occasione	NOM
alunno	NOM
dovunque	ADV
disposizione	NOM
rappresentazione	NOM
caloria	NOM
entrambi	ADJ
mostrare	VER:pres
trasformazione	NOM
ferragosto	NOM
vinto	ADJ
gestire	VER:pres
iscritto	ADJ
meraviglia	NOM
chiuso	ADJ
ciak	NOM
finalista	NOM
permettere	VER:pper
milione	NOM
sciogliere	VER:pres
scambiare	VER:infi
filo	NOM
amicizia	NOM
olimpico	ADJ
rappresentare	VER:pres
dio	NOM
ricetta	NOM
interessare	VER:pres
confrontare	VER:cpre
obbligo	NOM
bruciare	VER:pres
intuire	VER:pper
partecipante	NOM
gara	NOM
emigrare	VER:pper
personaggio	NOM
sito	NOM
pubblico	ADJ
recente	ADJ
produzione	NOM
divenire	VER:remo
americano	ADJ
perfetto	ADJ
collaborazione	NOM
festival	NOM
dibattito	NOM
percorso	NOM
liceo	NOM
inizialmente	ADV
soddisfare	VER:pper
ricerca	NOM
smarrito	ADJ
quattro	ADJ
esposto	ADJ
partecipare	VER:pper
risultare	VER:pper
rapporto	NOM
salmone	NOM
presente	ADJ
progetto	NOM
fermamente	ADV
decidere	VER:pres
destinatario	NOM
utilizzare	VER:infi
online	ADJ
invece	ADV
richiesta	NOM
assicurare	VER:pres
parziale	ADJ
europeo	ADJ
bocciare	VER:pper
proprio	ADV
eros	NPR
specializzato	ADJ
collezione	NOM
dimenticato	ADJ
toscano	ADJ
raffigurare	VER:pper
bellezza	NOM
altezza	NOM
trattare	VER:pres
saporito	ADJ
foro	NPR
ordine	NOM
lettura	NOM
proiezione	NOM
commerciale	ADJ
causa	NOM
accadere	VER:infi
raggiungere	VER:infi
peso	NOM
latino	NOM
stand	NOM
colpa	NOM
pancetta	NOM
ovviamente	ADV
docente	NOM
nessun	ADJ
cittadinanza	NOM
appassionare	VER:pper
paesaggio	NOM
shopping	NOM
spalla	NOM
sognare	VER:pres
cattiveria	NOM
denaro	NOM
legge	NOM
rispetto	NOM
scena	NOM
giurisprudenza	NOM
riguardare	VER:pres
difficoltà	NOM
gratuito	ADJ
produrre	VER:pper
vitamina	NOM
allegare	VER:infi
prevenire	VER:infi
trenta	ADJ
candela	NOM
certamente	ADV
rifiutare	VER:pres
innamorato	ADJ
lamentare	VER:pper
amato	ADJ
viso	NOM
allegato	ADJ
antichità	NOM
successivo	ADJ
influenza	NOM
innamorare	VER:pres
influenzare	VER:infi
iscrivere	VER:infi
scheda	NOM
registrare	VER:infi
incontro	NOM
segnale	NOM
fruttivendolo	NOM
smettere	VER:pper
realizzare	VER:pper
cassetto	NOM
partecipare	VER:infi
denominare	VER:pper
salsiccia	NOM
coltivare	VER:pper
anteprima	NOM
comportare	VER:pres
formato	NOM
semplice	ADJ
scorretto	ADJ
adatto	ADJ
dea	NOM
yogurt	NOM
oggigiorno	ADV
educativo	ADJ
altra	ADJ
cittadino	NOM
carbonaro	ADJ
partecipazione	NOM
filmato	NOM
pesticida	NOM
fattore	NOM
raccontare	VER:cpre
persino	ADV
telecamera	NOM
laurea	NOM
tour	NOM
severo	ADJ
disegno	NOM
canale	NOM
smettere	VER:pres
bozza	NOM
assicurato	ADJ
leggibile	ADJ
romano	ADJ
ciliegio	NOM
osservare	VER:infi
fondere	VER:cpre
brevettare	VER:impe
direttamente	ADV
porcino	ADJ
bruciare	VER:infi
incrocio	NOM
costume	NOM
orecchie	NOM
intervistato	NOM
argomento	NOM
presentare	VER:pres
restante	ADJ
cera	NOM
aurora	NPR
apprendistato	NOM
cerca	NOM
pubblicizzare	VER:infi
merluzzo	NOM
verità	NOM
obbligatorio	ADJ
esperto	ADJ
accettare	VER:pres
assumere	VER:pres
proibire	VER:pper
esprimere	VER:infi
trasferire	VER:infi
trasferire	VER:pper
misto	ADJ
negare	VER:pres
risalire	VER:ppre
dichiarare	VER:pper
elettronico	ADJ
fondare	VER:pper
video	NOM
mantenere	VER:infi
evitare	VER:pres
riconoscere	VER:cpre
fungo	NOM
venti	ADJ
necessario	ADJ
oroscopo	NOM
completamente	ADV
consegna	NOM
diventare	VER:cpre
menu	NOM
continente	NOM
numeroso	ADJ
affatto	ADV
affrontare	VER:infi
paternità	NOM
scritta	NOM
link	NOM
agricoltura	NOM
aggiungere	VER:impf
irlandese	ADJ
socia	NOM
aumentare	VER:infi
corsa	NOM
passione	NOM
acquisto	NOM
ricostruire	VER:pres
ottenere	VER:pper
rivoluzione	NOM
mediocre	ADJ
svedese	ADJ
progettare	VER:pres
veterinario	NOM
festeggiare	VER:infi
gentilezza	NOM
rovinare	VER:infi
capitare	VER:infi
regolare	ADJ
attaccare	VER:pres
rivolgere	VER:infi
consigliare	VER:infi
faticare	VER:pres
ricercatore	NOM
copiare	VER:infi
futuro	NOM
acquisire	VER:infi
garanzia	NOM
archeologico	ADJ
paese	NOM
innamorare	VER:infi
politico	ADJ
contenere	VER:pres
governo	NOM
weekend	NOM
psicologo	NOM
milanese	ADJ
castello	NOM
intero	ADJ
trasporto	NOM
chat	NOM
speciale	ADJ
autorevolezza	NOM
costruire	VER:pper
sostenere	VER:pres
interno	NOM
targa	NOM
informatico	NOM
dieta	NOM
comportare	VER:infi
definire	VER:pper
durata	NOM
statua	NOM
bastare	VER:pres
olimpiade	NOM
orecchino	NOM
vincitore	ADJ
maggiore	ADJ
appassionare	VER:pres
poster	NOM
contare	VER:infi
saio	NOM
applicazione	NOM
candidato	NOM
teatrale	ADJ
invio	NOM
aperto	ADJ
fermare	VER:pper
economico	ADJ
minorenne	ADJ
tortiglione	NOM
scientifico	ADJ
particolare	ADJ
consiglio	NOM
seguito	NOM
importare	VER:pres
maniera	NOM
manuale	ADJ
sano	ADJ
tavola	NOM
repubblica	NOM
tecnica	NOM
brillante	ADJ
servire	VER:pper
food	NOM
quindi	ADV
ammalare	VER:infi
ritenere	VER:pres
visitatore	NOM
utilizzare	VER:pres
gareggiare	VER:pper
azienda	NOM
immaginare	VER:infi
atleta	NOM
stipendio	NOM
architetto	NOM
massimo	ADJ
pagamento	NOM
famoso	ADJ
inadempimento	NOM
salutare	ADJ
scappare	VER:pres
cerimonia	NOM
almeno	ADV
estivo	ADJ
valore	NOM
dimostrare	VER:infi
commento	NOM
disturbo	NOM
baseball	NOM
riuscire	VER:pres
opera	NOM
ricordo	NOM
raccontare	VER:pper
capacità	NOM
test	NOM
costoso	ADJ
danza	NOM
ragù	NOM
coppa	NOM
impegnare	VER:pper
ritenere	VER:pper
ammettere	VER:pres
russo	ADJ
prodotto	NOM
sicuramente	ADV
inevitabile	ADJ
informare	VER:pres
vita	NOM
impiegare	VER:infi
addirittura	ADV
evoluzione	NOM
venditore	NOM
radiotelegrafia	NOM
originale	ADJ
mortale	ADJ
vulcano	NOM
voto	NOM
colpito	ADJ
diventare	VER:pres
durare	VER:pper
assicurazione	NOM
disporre	VER:pper
vaccino	NOM
mappa	NOM
terzo	ADJ
concentrare	VER:infi
apertura	NOM
alberato	ADJ
costruzione	NOM
invasione	NOM
direzione	NOM
particolare	NOM
iniziativa	NOM
mostro	NOM
premiare	VER:pres
compagnia	NOM
davvero	ADV
presentare	VER:pper
intervenire	VER:pres
istituzione	NOM
parere	NOM
inviare	VER:impf
materiale	ADJ
mente	NOM
soprattutto	ADV
immagine	NOM
macinato	ADJ
compilare	VER:infi
classificare	VER:pper
oltre	ADV
decollare	VER:impe
settanta	ADJ
base	NOM
tiramisù	NOM
grigliata	NOM
controllo	NOM
arrostito	ADJ
divertire	VER:pres
conoscente	NOM
rendere	VER:pres
bilancia	NOM
modo	NOM
climatico	ADJ
casella	NOM
semestre	NOM
ritirare	VER:infi
vegetariano	ADJ
dignitoso	ADJ
talento	NOM
inventare	VER:remo
rubrica	NOM
glutine	NOM
lira	NOM
danneggiare	VER:infi
gratuitamente	ADV
ministro	NOM
capace	ADJ
ripresa	NOM
possibilità	NOM
astronomia	NOM
esibizione	NOM
migliore	ADJ
nazionale	ADJ
presentazione	NOM
diffondere	VER:infi
crisi	NOM
termine	NOM
minore	ADJ
avvenire	VER:infi
dichiarazione	NOM
attivare	VER:infi
psiche	NOM
rotondo	ADJ
socio	NOM
curioso	ADJ
sarta	NOM
duramente	ADV
ubriaco	ADJ
alzare	VER:infi
sposato	ADJ
casolare	NOM
ospitare	VER:pres
esaminare	VER:pres
copia	NOM
cuoca	NOM
realizzare	VER:pres
contratto	NOM
diventare	VER:infi
severamente	ADV
fritto	ADJ
magnifico	ADJ
concorso	NOM
appassionato	ADJ
inoltre	ADV
regola	NOM
innamorato	NOM
rilassare	VER:infi
riuscire	VER:pper
allievo	NOM
universitario	ADJ
temere	VER:pres
sanità	NOM
fisica	NOM
seguito	ADJ
vendita	NOM
curatore	NOM
chiacchierare	VER:pres
stile	NOM
scoprire	VER:pper
colpire	VER:pper
emigrare	VER:pres
arrivato	ADJ
straordinario	ADJ
conosciuto	ADJ
tre	ADJ
inventare	VER:pper
super	NPR
informatico	ADJ
gestire	VER:infi
capitale	NOM
assumere	VER:infi
area	NOM
regina	NOM
guarire	VER:pres
intervistare	VER:infi
creare	VER:pper
condizione	NOM
privato	ADJ
perfino	ADV
vincere	VER:pper
occupare	VER:pres
britannico	ADJ
ignorare	VER:pper
avvicinare	VER:infi
trasferire	VER:pres
diffuso	ADJ
pentire	VER:pres
ampliamento	NOM
aumento	NOM
gamberoni	NOM
però	ADV
svegliare	VER:pres
fast	ADJ
comportamento	NOM
associazione	NOM
giudizio	NOM
riadattare	VER:pper
abbigliamento	NOM
incontentabile	ADJ
proporre	VER:cpre
influenzare	VER:pres
ne	ADV
carboidrato	NOM
fertilizzante	NOM
modifica	NOM
continuo	ADJ
attività	NOM
grammo	NOM
goccia	NOM
profumeria	NOM
novanta	ADJ
cliente	NOM
intraprendere	VER:infi
delicato	ADJ
considerevole	ADJ
pubblicato	ADJ
rispetto	ADV
abile	ADJ
scannerizzare	VER:infi
scadere	VER:pres
biologico	ADJ
arduo	ADJ
assicurare	VER:pper
preoccupare	VER:infi
mestiere	NOM
panna	NOM
spedizione	NOM
salutare	VER:pres
condividere	VER:infi
copertina	NOM
purtroppo	ADV
riprendere	VER:pper
congresso	NOM
fiscale	ADJ
disturbare	VER:infi
avvicinare	VER:pres
comodamente	ADV
trasformare	VER:infi
realtà	NOM
evitare	VER:infi
stagione	NOM
permettere	VER:pres
casuale	ADJ
offerta	NOM
generale	NOM
decidere	VER:infi
cantante	NOM
fermare	VER:infi
scaricabile	ADJ
cinque	ADJ
qualità	NOM
secolo	NOM
studioso	ADJ
crescita	NOM
manifestazione	NOM
epoca	NOM
assistere	VER:infi
cartaceo	ADJ
diventare	VER:pper
laboratorio	NOM
scendere	VER:pres
criticare	VER:pper
