ignorare	VER:pper
dettaglio	NOM
spalla	NOM
decollare	VER:impe
epoca	NOM
ripieno	ADJ
bambino 	NOM
riuscire	VER:pres
intraprendere	VER:infi
aggiungere	VER:impf
bellezza	NOM
produzione	NOM
successivamente	ADV
scenografia	NOM
divertire	VER:pres
capacità	NOM
amato	ADJ
destinatario	NOM
ammalare	VER:infi
persino	ADV
emozionato	ADJ
perfetto	NOM
stagione	NOM
cantante	NOM
mite	ADJ
arrotolato	ADJ
capitale	NOM
dieta	NOM
costruire	VER:pres
fondare	VER:pper
voto	NOM
rispetto	ADV
ammettere	VER:infi
incidente	NOM
dichiarare	VER:pper
pessimo	ADJ
peso	NOM
spedizione	NOM
trasferire	VER:pper
salpare	VER
inventare	VER:pper
specializzato	ADJ
incrocio	NOM
tavola	NOM
merluzzo	NOM
venditore	NOM
bruciare	VER:infi
decidere	VER:pper
orecchie	NOM
durata	NOM
pesare	VER:pres
presente	ADJ
archeologico	ADJ
tortiglione	NOM
difficoltà	NOM
shopping	NOM
svolgere	VER:pper
sottolineatura	NOM
proprio	ADV
vincere	VER:pres
finalmente	ADV
negare	VER:pres
divenire	VER:remo
grosso	ADJ
bisognare	VER:pres
osservare	VER:infi
salutare	ADJ
secolo	NOM
duramente	ADV
contatto	NOM
biologico	ADJ
stipendio	NOM
crisi	NOM
diventare	VER:infi
quindi	ADV
utilizzare	VER:pres
sposato	ADJ
rubrica	NOM
fertilizzante	NOM
esibizione	NOM
coppa	NOM
laurea	NOM
base	NOM
mancare	VER:cpre
grigliata	NOM
viale	NOM
particolare	NOM
climatico	ADJ
maniera	NOM
sognare	VER:pres
permettere	VER:pper
canale	NOM
rilassare	VER:infi
brillante	ADJ
racconto	NOM
specie	NOM
rappresentare	VER:pres
infine	ADV
bastare	VER:pres
biscotto	NOM
ubriaco	ADJ
sostenere	VER:pres
pesticida	NOM
considerevole	ADJ
caloria	NOM
carbonara	NOM
trasferire	VER:infi
festeggiare	VER:infi
modo	NOM
condividere	VER:infi
vincere	VER:pper
numeroso	ADJ
tour	NOM
inviare	VER:infi
agitare	VER:impf
cerimonia	NOM
cuoco	NOM
food	NOM
agricoltore	NOM
percorso	NOM
stabilimento	NOM
ricercatore	NOM
inglese	NOM
arrostito	ADJ
ricerca	NOM
riguardare	VER:pres
soprattutto	ADV
zoo	NOM
allestimento	NOM
fantasia	NOM
studioso	ADJ
osteria	NOM
preferito	ADJ
altitudine	NOM
faticare	VER:pres
chiacchierare	VER:pres
ormai	ADV
crescita	NOM
inevitabile	ADJ
economico	ADJ
trasformazione	NOM
regola	NOM
purtroppo	ADV
rapporto	NOM
cura	NOM
motivo	NOM
navigare	VER:geru
rallegrare	VER:pper
magico	ADJ
scolastico	ADJ
concorso	NOM
disposizione	NOM
disponibile	ADJ
ricostruire	VER:pres
presentare	VER:pper
area	NOM
somigliare	VER:pres
navigazione	NOM
stupire	VER
vegetariano	ADJ
utilizzare	VER:infi
premio	NOM
scambiare	VER:infi
riprendere	VER:pper
diventare	VER:pres
influenza	NOM
naturale	ADJ
semestre	NOM
gola	NOM
scorretto	ADJ
foto	NOM
esagerare	VER:infi
emozionante	ADJ
gareggiare	VER:infi
spaventare	VER:infi
comunque	ADV
tradizione	NOM
capitare	VER:infi
vario	ADJ
migliore	ADJ
successivo	ADJ
rispettare	VER:infi
qualità	NOM
fritto	ADJ
lusso	NOM
toscano	ADJ
rivoluzione	NOM
esperto	ADJ
continuo	ADJ
associazione	NOM
colle	NOM
saporito	ADJ
perfetto	ADJ
decisione	NOM
cipolla	NOM
antichità	NOM
fermare	VER:pper
paesaggio	NOM
giurisprudenza	NOM
video	NOM
costoso	ADJ
diritto	NOM
acquisire	VER:infi
weekend	NOM
sovrano	NOM
foro	NPR
rischiare	VER:pres
proprio	ADJ
universitario	ADJ
appassionare	VER:infi
svolgere	VER:pres
ampio	ADJ
consigliare	VER:pres
svedese	ADJ
agricoltura	NOM
scoprire	VER:pper
assumere	VER:pres
de	NPR
ne	ADV
misto	ADJ
recensione	NOM
fattore	NOM
ragù	NOM
strumento	NOM
adatto	ADJ
diffuso	ADJ
ammalato	ADJ
decidere	VER:infi
fisico	ADJ
meraviglia	NOM
panna	NOM
dedicare	VER:infi
evitare	VER:pres
famoso	ADJ
bilancia	NOM
marinaio	NOM
continuamente	ADV
maggiore	ADJ
occasione	NOM
disturbo	NOM
campionato	NOM
determinato	ADJ
concedere	VER:pres
regina	NOM
yogurt	NOM
certamente	ADV
smettere	VER:pres
intervista	NOM
rotondo	ADJ
dimostrare	VER:infi
delicato	ADJ
sugo	NOM
usato	NOM
ridotto	ADJ
comitato	NOM
cinematografico	ADJ
gente	NOM
commissione	NOM
siberiano	ADJ
ferragosto	NOM
diffondere	VER:pper
aumento	NOM
possibilità	NOM
lamentare	VER:pper
generale	NOM
statua	NOM
caso	NOM
immaginare	VER:infi
americano	ADJ
menu	NOM
scritta	NOM
ospitare	VER:pper
acquisto	NOM
principale	ADJ
vincitore	ADJ
davvero	ADV
colpa	NOM
re	NOM
sano	ADJ
temere	VER:pres
rivolgere	VER:infi
vestire	VER:pres
soffrire	VER:infi
ingrediente	NOM
mente	NOM
sicuramente	ADV
tradizionale	ADJ
necessario	ADJ
olimpiade	NOM
superiore	ADJ
preparativo	NOM
leggibile	ADJ
scherzare	VER:pper
boutique	NOM
impiegare	VER:infi
consumare	VER:pres
fast	ADJ
neanche	ADV
gareggiare	VER:pper
però	ADV
usato	ADJ
vietato	ADJ
apprendistato	NOM
oltre	ADV
trattare	VER:pres
vita	NOM
attore	NOM
architetto	NOM
diventare	VER:pper
trasmettere	VER:pper
dignitoso	ADJ
crescere	VER:pres
direzione	NOM
innamorare	VER:pper
malessere	NOM
accettare	VER:pres
olimpico	ADJ
ospitare	VER:infi
emigrare	VER:pper
servire	VER:pres
mestiere	NOM
risalire	VER:ppre
astronomia	NOM
disturbare	VER:infi
prevenire	VER:infi
cassetto	NOM
chat	NOM
trasporto	NOM
innamorato	ADJ
pancetta	NOM
casuale	ADJ
permettere	VER:infi
estivo	ADJ
chiuso	ADJ
europeo	ADJ
prelibatezza	NOM
progetto	NOM
continente	NOM
serenamente	ADV
influenzare	VER:pres
svolgere	VER:infi
stand	NOM
candidato	NOM
approfittare	VER:geru
fagiolo	NOM
speciale	ADJ
ottimo	ADJ
dina	NP
disporre	VER:pper
coltivare	VER:pper
mediocre	ADJ
cliente	NOM
discutere	VER:impf
uso	NOM
tiramisù	NOM
vaccino	NOM
severo	ADJ
abilità	NOM
questione	NOM
scendere	VER:pres
consegnare	VER:infi
decorare	VER:pper
ecc	ADV
oggigiorno	ADV
alzare	VER:infi
salsiccia	NOM
innamorato	NOM
società	NOM
sintomo	NOM
addirittura	ADV
semplice	ADJ
mantenere	VER:infi
risultare	VER:pper
consigliare	VER:infi
vinto	ADJ
rendere	VER:pres
altezza	NOM
perfettamente	ADV
minore	ADJ
attribuire	VER:infi
legato	ADJ
comportamento	NOM
facilmente	ADV
metodo	NOM
discutere	VER:pres
alberato	ADJ
costruzione	NOM
fruttivendolo	NOM
ritenere	VER:pres
comunicare	VER:impf
recente	ADJ
ricetta	NOM
liberare	VER:infi
intervistare	VER:pper
categoria	NOM
carboidrato	NOM
classificare	VER:pper
comprensibile	ADJ
colonizzazione	NOM
duro	ADJ
conseguenza	NOM
abbattere	VER:pres
magnifico	ADJ
telecamera	NOM
concentrare	VER:infi
denominare	VER:pper
appassionato	ADJ
evitare	VER:infi
paesaggistico	ADJ
prodotto	NOM
allenare	VER:pper
ammirare	VER:infi
costruire	VER:pper
meraviglioso	ADJ
vendita	NOM
inviare	VER:impf
dandy	NOM
fermare	VER:infi
affatto	ADV
ministro	NOM
massimo	NOM
immagine	NOM
intervistare	VER:infi
almeno	ADV
profumeria	NOM
fermare	VER:pres
personaggio	NOM
eterno	ADJ
mortale	ADJ
stato	NOM
definire	VER:pper
diventare	VER:cpre
raccontare	VER:cpre
cambiamento	NOM
conosciuto	ADJ
paese	NOM
straordinario	ADJ
attività	NOM
intervistare	VER:futu
tipo	NOM
fermamente	ADV
corsa	NOM
macinato	ADJ
inglese	ADJ
baseball	NOM
comunicare	VER:infi
svolgimento	NOM
salmone	NOM
restante	ADJ
riuscire	VER:pper
porcino	ADJ
diffondere	VER:infi
partecipare	VER:infi
pubblicare	VER
seguito	ADJ
volo	NOM
impresa	NOM
salutare	VER:pres
vietare	VER:pper
produrre	VER:pper
stile	NOM
sanità	NOM
online	ADJ
soddisfare	VER:pper
inoltre	ADV
medio	ADJ
copiare	VER:infi
durare	VER:pper
raccontare	VER:pper
trasferimento	NOM
aumentare	VER:infi
movimento	NOM
coniuge	NOM
affrontare	VER:infi
invece	ADV
poverino	ADJ
accadere	VER:infi
realtà	NOM
verità	NOM
controllo	NOM
affascinante	ADJ
fungo	NOM
emigrare	VER:pres
affidare	VER:infi
pentire	VER:pres
spagnolo	ADJ
appoggio	NOM
sogno	NOM
disporre	VER:pres
invenzione	NOM
intervistato	NOM
accurato	ADJ
romano	ADJ
litigare	VER:infi
occupare	VER:pres
copertina	NOM
raggiungere	VER:pres
cotechino	NOM
collezione	NOM
preoccupare	VER:infi
casolare	NOM
ottenere	VER:pper
gamberoni	NOM
comunicazione	NOM
gara	NOM
sbagliato	ADJ
glutine	NOM
iniziativa	NOM
colpire	VER:pper
avvocato	NOM
impegnato	ADJ
edificio	NOM
grammo	NOM
vitamina	NOM
causa	NOM
risparmiare	VER:infi
progettare	VER:pres
incontro	NOM
rispetto	NOM
futuro	NOM
tirocinio	NOM
raggiungere	VER:infi
apertura	NOM
ultimamente	ADV
rivolgere	VER:pres
consiglio	NOM
scadere	VER:infi
apprezzare	VER:pper
severamente	ADV
criticare	VER:pper
ordine	NOM
ovviamente	ADV
assumere	VER:infi
inventare	VER:remo
partecipare	VER:pper
atleta	NOM
critico	NOM
servire	VER:pper
arrivato	ADJ
registrare	VER:infi
legge	NOM
guarire	VER:pres
ritenere	VER:pper
contenere	VER:pres
obbligatorio	ADJ
termine	NOM
cattiveria	NOM
edizione	NOM
comportare	VER:impe
arduo	ADJ
incantevole	ADJ
intero	ADJ
foresta	NOM
manuale	ADJ
azienda	NOM
superare	VER:pper
fa	ADV
costituzione	NOM
nazionale	ADJ
decidere	VER:pres
importare	VER:pres
condizione	NOM
bocciare	VER:pper
