servire	VER:pres
riversare	VER:pper
sviluppo	NOM
violino	NOM
causa	NOM
tedesco	ADJ
trucco	NOM
fondo	NOM
atmosfera	NOM
motivo	NOM
cenetta	NOM
compagnia	NOM
però	ADV
crollare	VER:pper
comporre	VER:infi
dichiarare	VER:pper
punire	VER:pper
abitualmente	ADV
salire	VER:infi
rendere	VER:infi
semplice	ADJ
socializzare	VER:infi
qualità	NOM
scherzo	NOM
allerta	NOM
sito	NOM
affatto	ADV
minore	ADJ
stabilire	VER:infi
investimento	NOM
base	NOM
fattore	NOM
inoltre	CON 
condizionare	VER:pper
servire	VER:impf
servizio	NOM
artista	NOM
pancia	NOM
sostenere	VER:infi
discarica	NOM
efficacia	NOM
riuscire	VER:cond
sufficiente	ADJ
riuscire	VER:remo
creare	VER:pres
controllare	VER:impf
assumere	VER:pper
tipico	ADJ
pratica	NOM
quotidiano	ADJ
diventare	VER:infi
inciviltà	NOM
realmente	ADV
cadere	VER:pres
allarmante	ADJ
fantasia	NOM
scolpito	ADJ
trasmettere	VER:pres
strumento	NOM
capricorno	NOM
sensazionale	ADJ
idoneo	ADJ
accettare	VER:pper
segno	NOM
tecnologia	NOM
occorrere	VER:pres
provocare	VER:infi
corridoio	NOM
annuncio	NOM
aumento	NOM
scarico	NOM
pazienza	NOM
prodotto	NOM
catechina	NOM
utilizzare	VER:infi
scendere	VER:pper
ovviamente	ADV
acquisto	NOM
stancare	VER:pper
accogliere	VER:pres
impegnare	VER:pper
risparmio	NOM
conclusione	NOM
opera	NOM
derubare	VER:pper
consecutivo	ADJ
traduttore	NOM
scorpione	NOM
offerta	NOM
presente	ADJ
quotidianamente	ADV
permettere	VER:infi
furto	NOM
produrre	VER:cpre
disabile	NOM
pianeta	NOM
requisito	NOM
ventenne	ADJ
paese	NOM
calcetto	NOM
usanza	NOM
considerare	VER:pper
diffondere	VER:pper
provvedimento	NOM
scontato	ADJ
accettare	VER:infi
buono	ADJ
scoprire	VER:infi
manifestare	VER:pres
permettere	VER:pres
accadere	VER:pper
accorgere	VER:infi
sviluppare	VER:pper
artistico	ADJ
privato	ADJ
ottimo	ADJ
conseguenza	NOM
inferiore	ADJ
condizionare	VER:pres
rifiuto	NOM
sostanza	NOM
ininterrottamente	ADV
migliore	ADJ
è	NOM
nemmeno	ADV
dirigere	VER
creare	VER:cpre
impegnare	VER:impf
storiella	NOM
scivolo	NOM
comodamente	ADV
tema	NOM
sconsiderato	ADJ
risparmiare	VER:infi
profondo	NOM
rifiutare	VER:pres
bilancio	NOM
prenotazione	NOM
calcolo	NOM
effetto	NOM
inoltre	ADV
disposizione	NOM
coperto	ADJ
sfortunatamente	ADV
intervento	NOM
specializzare	VER:pper
lettura	NOM
rischio	NOM
intervistare	VER:pper
purtroppo	ADV
fedele	ADJ
fogna	NOM
invito	NOM
bel	ADJ
pietra	NOM
ripassare	VER:infi
incidente	NOM
avventura	NOM
raramente	ADV
talento	NOM
grammatica	NOM
denuncia	NOM
sporgere	VER:infi
consumo	NOM
persino	ADV
festeggiato	NOM
docente	NOM
tonnellata	NOM
legame	NOM
servire	VER:cimp
passaggio	NOM
concentrazione	NOM
percentuale	NOM
proporre	VER:impf
curare	VER:pper
sovrappensiero	NOM
traduzione	NOM
gettare	VER:pper
alligatore	NOM
semplificare	VER:infi
abbandonare	VER:pper
schiena	NOM
settore	NOM
accadere	VER:pres
soffrire	VER:pper
passerella	NOM
canale	NOM
evento	NOM
commissionare	VER:infi
liquido	NOM
migliorare	VER:infi
improvvisare	VER:infi
difficoltà	NOM
malanno	NOM
eccellente	ADJ
liberamente	ADV
giada	NPR
coccolare	VER:pper
gesto	NOM
scelta	NOM
archeologia	NOM
fiducioso	ADJ
riordinare	VER:infi
numeroso	ADJ
proprio	ADJ
consigliare	VER:pper
celebre	ADJ
turno	NOM
laurea	NOM
bocciare	VER:pper
futuro	NOM
inventato	ADJ
raccontare	VER:pper
infanzia	NOM
ariete	NOM
interessare	VER:cond
pallino	NOM
fa	ADV
falda	NOM
uso	NOM
attesa	NOM
imbiancare	VER:infi
robot	NOM
contaminare	VER:pres
discordante	ADJ
guadagnare	VER:pper
riflettere	VER:infi
passatempo	NOM
significativo	ADJ
necessitare	VER:pres
enzima	NOM
dimostrare	VER:pper
fastidioso	ADJ
necessità	NOM
rubare	VER:pper
eccezionale	ADJ
ingenuamente	ADV
particolare	ADJ
arricchire	VER:infi
tipo	NOM
considerare	VER:infi
guadagno	NOM
decidere	VER:remo
prova	NOM
quadrare	VER:infi
impedire	VER:pres
risalire	VER:cpre
resistenza	NOM
graduale	ADJ
economico	ADJ
smog	NOM
magari	ADV
capitano	NOM
agio	NOM
riflessione	NOM
festival	NOM
svenire	VER:remo
mescolare	VER:pper
smettere	VER:infi
crisi	NOM
cosiddetto	ADJ
maniera	NOM
magno	ADJ
laboratorio	NOM
parecchio	ADV
ricoprire	VER:pper
aperto	ADJ
influenzare	VER:cpre
latte	NOM
costringere	VER:pper
valere	VER:pres
adottare	VER:infi
personalmente	ADV
completamente	ADV
soluzione	NOM
formale	ADJ
scavare	VER:geru
personale	NOM
comportare	VER:pres
aggiunta	NOM
unico	ADJ
risparmiatore	NOM
lottare	VER:pres
proprio	ADV
diventare	VER:cimp
particolare	NOM
marciapiede	NOM
impegnare	VER:cpre
ripiego	NOM
insomma	ADV
aggiungere	VER:pres
lotto	NOM
quantità	NOM
colpire	VER:pres
vedova	NOM
aggiungere	VER:infi
critico	NOM
infelice	ADJ
davvero	ADV
sindaco	NOM
testardo	ADJ
scienziato	NOM
vicinanza	NOM
fantastico	ADJ
rivelare	VER:remo
fosso	NOM
iscrivere	VER:infi
divenire	VER:remo
ritenere	VER:pres
descrivere	VER:infi
bevanda	NOM
cinese	NOM
malattia	NOM
corsa	NOM
alternare	VER:futu
diploma	NOM
preoccupante	ADJ
cura	NOM
poliziotto	NOM
spunto	NOM
diffusione	NOM
buco	NOM
volo	NOM
riordinare	VER:geru
abbandonato	ADJ
conferenza	NOM
architettonico	ADJ
trattare	VER:cimp
offendere	VER:pres
pubblico	ADJ
tubatura	NOM
governo	NOM
notizia	NOM
preoccupare	VER:pper
laureare	VER:cimp
ingrediente	NOM
infine	ADV
incredibile	ADJ
mandare	VER:remo
vita	NOM
bisognare	VER:cimp
manifestare	VER:infi
dettagliato	ADJ
nervosismo	NOM
tariffa	NOM
esperto	NOM
oltre	ADV
ricadere	VER:pres
pentire	VER:cond
seguito	NOM
occupare	VER:pres
esigente	ADJ
ozono	NOM
dimagrire	VER:infi
vantaggio	NOM
indicare	VER:pper
locale	ADJ
lista	NOM
test	NOM
dieta	NOM
fattorino	NOM
cittadino	NOM
severamente	ADV
progetto	NOM
attribuire	VER:remo
orale	ADJ
pur	ADV
crollare	VER:pres
desistere	VER:infi
liceo	NOM
secolo	NOM
attendere	VER:pres
gruppo	NOM
impegno	NOM
ostruire	VER:pper
soddisfatto	ADJ
rispetto	NOM
fondente	ADJ
matematico	ADJ
fondare	VER:pper
inglese	NOM
stringere	VER:infi
grave	ADJ
condizionatore	NOM
bravata	NOM
servire	VER:infi
tradurre	VER:pper
invece	ADV
radicalmente	ADV
europeo	ADJ
decidere	VER:pper
fiero	ADJ
rete	NOM
dibattito	NOM
ripiegare	VER:infi
costoso	ADJ
ripercuotere	VER:futu
composizione	NOM
altrimenti	ADV
punizione	NOM
cruciverba	NOM
presidente	NOM
decidere	VER:infi
cortese	ADJ
consumare	VER:impf
riscontro	NOM
inosservato	ADJ
pensionato	ADJ
indimenticabile	ADJ
rivivere	VER:infi
originale	ADJ
ricercatore	NOM
esporre	VER:impf
bastare	VER:pres
probabilità	NOM
complicare	VER:pper
diventare	VER:pper
paga	NOM
comune	NOM
innegabile	ADJ
archeologo	NOM
riguardare	VER:pres
dedicare	VER:pres
velocemente	ADV
ambientale	ADJ
aumentare	VER:pper
influire	VER:cpre
prediligere	VER:infi
telegiornale	NOM
raro	ADJ
proposito	NOM
colpire	VER:remo
pertanto	ADV
del	PRE:Det
offendere	VER:cimp
basare	VER:pres
naturale	ADJ
informatica	NOM
responsabile	ADJ
fenomeno	NOM
recare	VER:infi
ritenere	VER:infi
apprendere	VER:infi
viso	NOM
mossa	NOM
cacao	NOM
zodiacale	ADJ
evidente	ADJ
contattare	VER:pres
proposta	NOM
mestiere	NOM
conveniente	ADJ
notare	VER:pper
trattare	VER:impf
necessario	ADJ
puro	ADJ
popolo	NOM
aumentare	VER:pres
elemento	NOM
meteo	NOM
minimo	ADJ
illustre	ADJ
punire	VER:remo
centinaio	NOM
trasferire	VER:remo
adolescente	NOM
spostare	VER:infi
musicale	ADJ
atteggiamento	NOM
profano	NOM
movimento	NOM
canile	NOM
complesso	ADJ
riciclabile	ADJ
terribilmente	ADJ
ripieno	ADJ
abitudine	NOM
scioglimento	NOM
aereo	ADJ
voto	NOM
sfruttare	VER:infi
capotreno	NOM
montascale	NOM
aggiungere	VER
rotella	NOM
rendere	VER:pres
preside	NOM
informatico	ADJ
marca	NOM
bisognare	VER:pres
crescere	VER:infi
associazione	NOM
vantaggioso	ADJ
inquinamento	NOM
negativo	ADJ
innamorare	VER:pper
riuscire	VER:infi
realizzare	VER:pper
scambio	NOM
muratore	NOM
dipendenza	NOM
maturità	NOM
sudare	VER:pres
scottare	VER:impf
realtà	NOM
dimagrante	ADJ
diventare	VER:remo
sognare	VER:geru
barriera	NOM
agitazione	NOM
imbianchino	NOM
perdita	NOM
scoprire	VER:remo
aspetto	NOM
richiesta	NOM
abolizione	NOM
stupido	NOM
fermare	VER:infi
fornire	VER:pper
ricevuta	NOM
raccontare	VER:infi
recente	ADJ
astro	NOM
riparare	VER:pper
arabo	NOM
convinto	ADJ
collaborazione	NOM
soprattutto	ADV
struttura	NOM
discount	NOM
gradino	NOM
superare	VER:remo
accogliere	VER:pper
avvenimento	NOM
innamorare	VER:remo
titolo	NOM
porgere	VER:pres
passo	NOM
indispensabile	ADJ
autista	NOM
abbigliamento	NOM
ghiacciaio	NOM
dato	NOM
dimagrimento	NOM
stressante	ADJ
crescere	VER:pper
avviso	NOM
calmare	VER:pper
consigliare	VER:remo
scritto	ADJ
ostacolo	NOM
raggiungere	VER:pper
scomparso	ADJ
scoprire	VER:pper
cioccolatino	NOM
emozionante	ADJ
bordo	NOM
inconveniente	NOM
metropolitano	ADJ
disperatamente	ADV
invitato	NOM
minacciare	VER:pres
almeno	ADV
insegnamento	NOM
conoscenza	NOM
sottovalutare	VER:infi
emissione	NOM
relazione	NOM
fissare	VER:infi
crollo	NOM
accorgere	VER:pres
adottare	VER:pper
instabile	ADJ
leggenda	NOM
sciocco	NOM
fantasioso	ADJ
van	NPR
famoso	ADJ
rivelare	VER:infi
compositore	NOM
passante	NOM
temere	VER:infi
addirittura	ADV
ombrellone	NOM
maggiore	ADJ
apprezzare	VER:infi
pubblicità	NOM
sedere	VER:pper
grammaticale	ADJ
istituto	NOM
richiedere	VER:pper
costruire	VER:cond
serra	NOM
desiderare	VER:pres
ricerca	NOM
regola	NOM
coccodrillo	NOM
divertire	VER:pper
specie	NOM
vegetale	ADJ
parcheggiare	VER:pper
sogno	NOM
conoscente	NOM
inviare	VER:pper
allarmare	VER:infi
civico	ADJ
successivamente	ADV
fidanzare	VER:pper
ingegneria	NOM
epoca	NOM
verità	NOM
affidare	VER:pres
precedente	ADJ
statistica	NOM
porre	VER:pper
importanza	NOM
imbarazzante	ADJ
disturbo	NOM
funzionare	VER:pres
astrologo	NOM
presenza	NOM
ladro	NOM
interrogazione	NOM
modo	NOM
tale	ADJ
ormai	ADV
veterinario	NOM
fatto	NOM
capace	ADJ
capitare	VER:pper
cordiale	ADJ
smettere	VER:pres
dapprima	ADV
nazionale	ADJ
partecipazione	NOM
preparato	ADJ
scultura	NOM
gente	NOM
passione	NOM
disponibile	ADJ
navigare	VER:infi
annoiare	VER:pper
riflettere	VER:cimp
stimolo	NOM
vario	ADJ
estinzione	NOM
ingrassare	VER:infi
tradurre	VER:infi
spaventare	VER:pres
salvare	VER:pper
ultimamente	ADV
elencare	VER:pper
ritenere	VER:remo
specifico	ADJ
avvenire	VER:pres
disavventura	NOM
ricercare	VER:infi
prezioso	ADJ
rischiare	VER:impf
indubbiamente	ADV
rischiare	VER:pres
riconoscere	VER:pper
capitare	VER:impf
cauto	ADJ
caratteristica	NOM
interazione	NOM
corte	NOM
figuraccia	NOM
raccontare	VER:pres
cadere	VER:pper
vista	NOM
raccogliere	VER:pres
disabile	ADJ
favorire	VER:pres
decennio	NOM
spaventare	VER:infi
regolarmente	ADV
speciale	ADJ
consiliare	ADJ
abile	ADJ
sede	NOM
incognita	NOM
parsimonioso	ADJ
psicologo	NOM
comparare	VER:infi
ritirare	VER:infi
personalità	NOM
sintomo	NOM
acquifero	ADJ
madrelingua	NOM
duramente	ADV
parcheggiare	VER:infi
amicizia	NOM
impresa	NOM
reale	ADJ
saziare	VER:pres
ritrovamento	NOM
cerca	NOM
rilevare	VER:pper
laureare	VER:pper
estetica	NOM
lotteria	NOM
esperienza	NOM
incubo	NOM
accadere	VER:remo
professionista	NOM
esponente	NOM
massa	NOM
piacevole	ADJ
delicato	ADJ
guadagnare	VER:infi
prenotato	ADJ
pianista	NOM
consiglio	NPR
pralina	NOM
cinese	ADJ
commercio	NOM
presentare	VER:impf
salire	VER:pper
sottolineare	VER:pres
oroscopo	NOM
