progresso	NOM
maggiormente	ADV
riflettere	VER:infi
specialistico	ADJ
esigente	ADJ
portafoglio	NOM
cervo	NOM
riportare	VER:impf
prevalenza	NOM
cenetta	NOM
caratteristico	ADJ
maggiore	ADJ
sociale	ADJ
rispetto	NOM
vita	NOM
spostare	VER:infi
discarica	NOM
servizio	NOM
ingiustizia	NOM
eccellente	ADJ
montascale	NOM
funzionare	VER:pres
concittadino	NOM
mandare	VER:pper
accogliere	VER:pres
libertà	NOM
ballerina	NOM
punire	VER:remo
decidere	VER:remo
ottenere	VER:pper
risultare	VER:remo
dimostrare	VER:pres
dimagrire	VER:infi
buco	NOM
pratica	NOM
sintomo	NOM
artistico	ADJ
barriera	NOM
ininterrottamente	ADV
contare	VER
breve	ADJ
posizione	NOM
riguardo	NOM
scienziato	NOM
sognare	VER:pres
trappola	NOM
calcolo	NOM
posizionare	VER:pper
liquido	NOM
massa	NOM
consigliare	VER:pper
personalmente	ADV
efficacia	NOM
disavventura	NOM
orgoglio	NOM
bisognare	VER:pres
fondare	VER:remo
acustico	ADJ
territorio	NOM
fiero	ADJ
passerella	NOM
malanno	NOM
semplificare	VER:infi
rivivere	VER:infi
spostare	VER:cimp
criterio	NOM
ala	NOM
turismo	NOM
promozione	NOM
etico	ADJ
sciocco	NOM
centrale	ADJ
nemmeno	ADV
atteggiamento	NOM
cadere	VER:infi
formale	ADJ
preservare	VER:infi
celebre	ADJ
mandare	VER:remo
corte	NOM
docente	NOM
archeologo	NOM
coraggio	NOM
specifico	ADJ
impaziente	ADJ
passaggio	NOM
orale	ADJ
proporre	VER:remo
decidere	VER:infi
estinzione	NOM
baita	NOM
astro	NOM
contenere	VER:infi
sfortunatamente	ADV
affidare	VER:pper
successivamente	ADV
radunare	VER:pper
approfondimento	NOM
diffondere	VER:pper
rivista	NOM
fattorino	NOM
proprio	ADJ
carriera	NOM
illustre	ADJ
consumare	VER:impf
ariete	NOM
capitare	VER:impf
romano	NOM
riunire	VER:remo
segreto	NOM
differente	ADJ
tonnellata	NOM
spina	NOM
conveniente	ADJ
modo	NOM
partecipazione	NOM
vistare	VER:pres
fondare	VER:infi
accoglienza	NOM
emozionante	ADJ
zodiacale	ADJ
mescolare	VER:pper
gran	ADJ
nascita	NOM
circolare	VER:cimp
invidia	NOM
situare	VER:pper
faunistico	ADJ
incognita	NOM
canale	NOM
scomparso	ADJ
esporre	VER:impf
traccia	NOM
scambio	NOM
distinguere	VER:infi
impegnare	VER:impf
regista	NOM
sottrarre	VER:infi
fogna	NOM
recuperare	VER:pper
sicuramente	ADV
discount	NOM
metropolitano	ADJ
folle	ADJ
salto	NOM
ripercuotere	VER:futu
aumento	NOM
aumentare	VER:pres
generosità	NOM
ammirazione	NOM
apatia	NOM
integrato	ADJ
bel	ADJ
convincere	VER:infi
ritrovamento	NOM
pietra	NOM
sbagliato	ADJ
passione	NOM
riuscire	VER:remo
disperatamente	ADV
grave	ADJ
attribuire	VER:remo
dirigere	VER:infi
concorso	NOM
acquifero	ADJ
cogliere	VER:infi
astrologo	NOM
civico	ADJ
ghiacciaio	NOM
discolpare	VER:infi
rinchiudere	VER:pper
lupa	NOM
tomba	NOM
pauroso	ADJ
evidente	ADJ
pallino	NOM
valle	NOM
accorgere	VER:pres
innanzitutto	ADV
settore	NOM
associazione	NOM
raccontare	VER:remo
limite	NOM
fastidio	NOM
regolarmente	ADV
considerare	VER:pper
arcobaleno	NOM
fisso	ADJ
dettagliato	ADJ
resistenza	NOM
possedere	VER:impf
davvero	ADV
nemico	NOM
vantaggio	NOM
egoismo	NOM
fornire	VER:infi
proposito	NOM
suonato	ADJ
ripassare	VER:infi
avviso	NOM
impero	NOM
motivazione	NOM
ripetutamente	ADV
stagione	NOM
sostanza	NOM
titolo	NOM
mania	NOM
cura	NOM
schiena	NOM
entusiasmo	NOM
madrelingua	NOM
pepita	NOM
vestire	VER:pres
insegnamento	NOM
creare	VER:pres
nascondino	NOM
ricoprire	VER:pper
crescere	VER:pper
trionfo	NOM
responsabilità	NOM
laureare	VER:cimp
enzima	NOM
esperienza	NOM
lottare	VER:pres
presidente	NOM
tradurre	VER:infi
trasferire	VER:remo
conoscente	NOM
privato	ADJ
punizione	NOM
inferiore	ADJ
motto	NOM
grammatica	NOM
desiderare	VER:infi
occasione	NOM
veterinario	NOM
soffrire	VER:infi
condizione	NOM
panorama	NOM
vario	ADJ
ricevuta	NOM
affilare	VER:infi
capricorno	NOM
approfittare	VER:geru
tariffa	NOM
fiorino	NOM
gridare	VER:remo
aspetto	NOM
riconoscere	VER:pper
serie	NOM
universitario	ADJ
cioccolatino	NOM
ombra	NOM
trucco	NOM
radicalmente	ADV
conferenza	NOM
diventare	VER:remo
teologia	NOM
cadere	VER:pres
perdono	NOM
posare	VER:pres
relazione	NOM
diventare	VER:infi
bottega	NOM
curare	VER:pper
smettere	VER:infi
cristallino	ADJ
dato	NOM
cortese	ADJ
artista	NOM
permettere	VER:infi
arricchire	VER:infi
scorgere	VER:pper
mistero	NOM
coordinare	VER:infi
coccodrillo	NOM
provvedimento	NOM
lealtà	NOM
salvezza	NOM
annuncio	NOM
lupo	NOM
proporre	VER:pres
grotta	NOM
inciampare	VER:remo
disturbo	NOM
poté	NOM
terribilmente	ADJ
pensionato	ADJ
diploma	NOM
incubo	NOM
accettare	VER:remo
è	NOM
crollare	VER:pper
affacciare	VER:geru
decidere	VER:pper
fondale	NOM
trovatosi	NOM
superbia	NOM
ventenne	ADJ
vegetale	ADJ
scarico	NOM
personale	NOM
governo	NOM
euforia	NOM
visionario	NOM
influenzare	VER:cpre
periodo	NOM
tema	NOM
passatempo	NOM
comune	NOM
ladro	NOM
imbarazzante	ADJ
giada	NPR
serra	NOM
rete	NOM
dolorante	ADJ
dipendenza	NOM
scolastico	ADJ
severamente	ADV
comunità	NOM
multimediale	ADJ
scelto	ADJ
parere	VER:pres
impegnare	VER:pper
struttura	NOM
coperto	ADJ
aperto	ADJ
trasmettere	VER:pres
rotella	NOM
utilizzare	VER:infi
permettere	VER:pres
componente	NOM
azienda	NOM
volo	NOM
gruppo	NOM
pianeta	NOM
condizionare	VER:pres
ferire	VER:pper
derubare	VER:pper
consiglio	NOM
ringraziare	VER:infi
epoca	NOM
contrario	NOM
pentire	VER:cond
fronda	NOM
destrezza	NOM
abitudine	NOM
dimagrimento	NOM
ente	NOM
raggiungere	VER:infi
scrittore	NOM
trattare	VER:pres
maestra	NOM
latta|latte	NOM
quotidiano	ADJ
aggiunta	NOM
istituto	NOM
manifestare	VER:pper
mondiale	ADJ
tradire	VER:pper
qualità	NOM
grandezza	NOM
rischio	NOM
ascoltatore	NOM
profanare	VER:infi
turno	NOM
fondazione	NOM
poveraccio	NOM
festival	NOM
forestiero	NOM
risparmiare	VER:infi
costruzione	NOM
semplice	ADJ
consecutivo	ADJ
rifiuto	NOM
dibattito	NOM
dirigere	VER
commovente	ADJ
partecipare	VER:infi
bastare	VER:pres
speciale	ADJ
apprezzare	VER:infi
sindaco	NOM
fatto	NOM
parecchio	ADJ
navigare	VER:infi
imperatore	NOM
pazienza	NOM
pubblico	ADJ
consigliare	VER:remo
ferocia	NOM
concentrazione	NOM
influire	VER:cpre
equilibrato	ADJ
astuto	ADJ
minacciare	VER:pres
latino	ADJ
partecipare	VER:remo
comporre	VER:infi
pietoso	ADJ
bisognare	VER:cimp
originale	ADJ
cadere	VER:pper
comunicativo	ADJ
manifestare	VER:pres
allarmare	VER:infi
fidanzare	VER:pper
oblio	NOM
osservatorio	NOM
confronto	NOM
notare	VER:pper
avvenire	VER:pres
vespa	NOM
tale	ADJ
idoneo	ADJ
habitat	NOM
puro	ADJ
sede	NOM
tubatura	NOM
triennale	ADJ
spagnolo	ADJ
reincarnazione	NOM
servire	VER:impf
sovrappensiero	NOM
ovviamente	ADV
perfetto	ADJ
scorpione	NOM
improvviso	NOM
sfilare	VER:pres
diffondere	VER:infi
particolare	ADJ
ostacolo	NOM
richiesta	NOM
brigante	NOM
uccidere	VER:pper
svenire	VER:remo
timidezza	NOM
conoscenza	NOM
formativo	ADJ
ostruire	VER:pper
abitualmente	ADV
comune	ADJ
attività	NOM
borsetta	NOM
ritenere	VER:infi
furto	NOM
impegno	NOM
riuscire	VER:pper
laboratorio	NOM
meteo	NOM
riordinare	VER:geru
compagnia	NOM
nido	NOM
generazione	NOM
offendere	VER:cimp
salvare	VER:infi
riscontro	NOM
scendere	VER:pper
bilancio	NOM
credibile	ADJ
negativo	ADJ
fornire	VER:pper
percentuale	NOM
accorrere	VER:pper
contaminare	VER:pres
zona	NOM
esattamente	ADV
duro	ADJ
inconveniente	NOM
orso	NOM
velocemente	ADV
vista	NOM
van	NPR
malattia	NOM
dintorno	NOM
sudare	VER:pres
sedere	VER:pper
abbandonare	VER:remo
naturale	ADJ
migliore	ADJ
superiore	ADJ
salvaguardia	NOM
steccato	NOM
scritto	ADJ
favorire	VER:pres
rivelare	VER:remo
inosservato	ADJ
infanzia	NOM
dolore	NOM
interessare	VER:cond
però	ADV
sognare	VER:impf
oceano	NOM
immagine	NOM
cordiale	ADJ
desiderare	VER:pres
salire	VER:pper
riuscire	VER:impf
attendere	VER:pres
salvare	VER:pper
avvenimento	NOM
reinserire	VER:pper
passo	ADJ
professione	NOM
figuraccia	NOM
avvicinare	VER:pper
occupazione	NOM
abolizione	NOM
vantaggioso	ADJ
assieme	ADV
ricadere	VER:pres
antiquario	NOM
riuscire	VER:infi
ambiente	NOM
sito	NOM
intervento	NOM
farfalla	NOM
commissionare	VER:infi
prezioso	ADJ
incidente	NOM
scoraggiare	VER:infi
economico	ADJ
commercio	NOM
allegria	NOM
scavare	VER:geru
spostamento	NOM
aggiungere	VER:infi
crescere	VER:infi
magno	ADJ
calmare	VER:pper
rifiutare	VER:pres
vicinanza	NOM
romanzo	NOM
perdita	NOM
bevanda	NOM
comunicazione	NOM
informatico	ADJ
futuro	NOM
innamorare	VER:pper
impoverire	VER:pper
movimento	NOM
tradizionale	ADJ
esponente	NOM
maturità	NOM
ripopolare	VER:infi
costringere	VER:pper
costante	ADJ
smog	NOM
insomma	ADV
lato	NOM
teatrale	ADJ
indimenticabile	ADJ
bellezza	NOM
duramente	ADV
nulla	ADV
stimolo	NOM
fiducioso	ADJ
sognare	VER:geru
servire	VER:cimp
rischiare	VER:infi
concentrare	VER:pres
testardo	ADJ
locale	ADJ
attrezzo	NOM
personalità	NOM
forestiero	ADJ
assumere	VER:pper
dichiarare	VER:pper
interrogazione	NOM
risparmio	NOM
cerca	NOM
minacciare	VER:remo
turistico	ADJ
colloquio	NOM
accorgersi	VER:infi
sottovalutare	VER:infi
fantastico	ADJ
ricercatore	NOM
innegabile	ADJ
re	NOM
porgere	VER:pres
infine	ADV
prediligere	VER:infi
originario	NOM
popolazione	NOM
vizio	NOM
asciugacapelli	NOM
raro	ADJ
punire	VER:pper
passante	NOM
risultato	NOM
ripieno	ADJ
necessario	ADJ
ingegneria	NOM
fattore	NOM
cosiddetto	ADJ
consiglio	NPR
compiere	VER:remo
affatto	ADV
abbigliamento	NOM
sensibilizzazione	NOM
scivolo	NOM
costruire	VER:infi
diventare	VER:cimp
concludere	VER:pper
destino	NOM
distruggere	VER:infi
completamente	ADV
pralina	NOM
guadagnare	VER:infi
udire	VER:remo
usanza	NOM
purtroppo	ADV
base	NOM
fondo	NOM
bordo	NOM
riguardare	VER:pres
impervio	ADJ
parcheggiare	VER:infi
cadere	VER:remo
pianista	NOM
fedele	ADJ
accettare	VER:pper
personale	ADJ
contare	VER:remo
servire	VER:pres
pizzico	NOM
interazione	NOM
accadere	VER:remo
speranza	NOM
invitato	NOM
ostacolare	VER:pres
aggiunto	ADJ
sincerità	NOM
ritenere	VER:pres
altra	ADJ
parere	NOM
matematico	ADJ
applicato	ADJ
munire	VER:pper
discendere	VER:impf
cioccolata	NOM
origine	NOM
adottare	VER:pper
traduzione	NOM
meraviglioso	ADJ
concretezza	NOM
rinunciare	VER:pper
laurea	NOM
informatica	NOM
fastidioso	ADJ
disponibile	ADJ
percorso	NOM
ammirare	VER:pres
psicologo	NOM
avventura	NOM
smettere	VER:pres
diventare	VER:pper
prodotto	NOM
finalmente	ADV
imbiancare	VER:infi
disabile	NOM
insuccesso	NOM
frazione	NOM
fingere	VER:pper
condizionare	VER:pper
amicizia	NOM
senso	NOM
riprendere	VER:pper
presentare	VER:pper
scelta	NOM
prete	NOM
numeroso	ADJ
ormai	ADV
astronomia	NOM
soprattutto	ADV
mossa	NOM
effetto	NOM
divertire	VER:pper
bocciare	VER:pper
lente	NOM
apparire	VER:infi
locale	NOM
violino	NOM
paesaggio	NOM
dignitosamente	ADJ
vedova	NOM
colpire	VER:remo
rivolgere	VER:pres
lettura	NOM
interessare	VER:impf
ritirare	VER:infi
coordinatore	NOM
articolare	VER:pres
addirittura	ADV
neppure	ADV
laureare	VER:pper
gesto	NOM
arcivescovo	NOM
metodo	NOM
agitazione	NOM
desiderio	NOM
attimo	NOM
camoscio	NOM
significativo	ADJ
tipo	NOM
dirigere	VER:remo
riciclabili	ADJ
alligatore	NOM
indicare	VER:pper
legare	VER:pper
considerare	VER:infi
concludere	VER:pres
parcheggiare	VER:pper
rientrare	VER:futu
oroscopo	NOM
burocrazia	NOM
calcetto	NOM
giocatore	NOM
inventato	ADJ
merito	NOM
minore	ADJ
litigio	NOM
occupato	ADJ
corridoio	NOM
ripagare	VER:infi
almeno	ADV
ricerca	NOM
pur	ADV
arabo	NOM
chissà	ADV
poliziotto	NOM
compositore	NOM
risparmiatore	NOM
famoso	ADJ
ritenere	VER:remo
sacrificio	NOM
salire	VER:infi
apparire	VER:impf
preparato	ADJ
poeta	NOM
abbandonato	ADJ
fantasioso	ADJ
particolare	NOM
zampa	NOM
fosso	NOM
occupare	VER:pres
delicato	ADJ
notizia	NOM
scoprire	VER:remo
minimo	ADJ
stringere	VER:infi
area	NOM
condizionatore	NOM
secolo	NOM
riuscire	VER:cond
infelice	ADJ
cuoio	NOM
occorrere	VER:pres
accadere	VER:pres
difficoltà	NOM
testimonianza	NOM
sostenere	VER:infi
bussare	VER:remo
crollo	NOM
noia	NOM
muratore	NOM
edificio	NOM
impresa	NOM
vulcano	NOM
responsabile	ADJ
verità	NOM
guadagno	NOM
prova	NOM
combinazione	NOM
impegnare	VER:cpre
crisi	NOM
rendere	VER:infi
curiosità	NOM
ultima	ADJ
colpire	VER:pres
aggiungere	VER:pres
scientifico	ADJ
apprendere	VER:infi
bicocca	NPR
insicurezza	NOM
relativo	ADJ
fondo	ADJ
sporgere	VER:infi
capace	ADJ
pastore	NOM
rimbalzare	VER:pres
gemellare	VER:pper
nascondere	VER:pres
festeggiare	VER:infi
stabilire	VER:infi
emissione	NOM
riportare	VER:infi
contattare	VER:pres
afferrare	VER:infi
autista	NOM
dedicare	VER:pres
adottare	VER:infi
lotto	NOM
torrente	NOM
invito	NOM
raccontare	VER:pper
complicare	VER:pper
ramo	NOM
abitante	NOM
fenomeno	NOM
scusa	NOM
voto	NOM
sostenibilità	NOM
politica	NOM
reintrodurre	VER:pper
nascondiglio	NOM
partecipante	NOM
cinese	ADJ
articolato	ADJ
augurare	VER:pres
stupido	NOM
contare	VER:pres
convinto	ADJ
comparire	VER:infi
pubblicità	NOM
rendere	VER:pres
preoccupare	VER:pper
competitivo	ADJ
coccolare	VER:pper
respirare	VER:pres
fisica	NOM
rivelare	VER:infi
inoltre	CON 
rinchiuso	ADJ
chiuso	ADJ
assolutamente	ADV
tradurre	VER:pper
spaventare	VER:infi
proporre	VER:impf
inciviltà	NOM
prenotato	ADJ
intervistatore	NOM
allarmante	ADJ
svuotare	VER:pper
recare	VER:infi
essiccare	VER:pper
lassù	ADV
diffusione	NOM
composizione	NOM
viaggi	NOM
disposizione	NOM
grammaticale	ADJ
stressante	ADJ
instabile	ADJ
permettere	VER:remo
unico	ADJ
fucile	NOM
magari	ADV
corsa	NOM
scoprire	VER:pres
accadere	VER:pper
festeggiato	NOM
recente	ADJ
segno	NOM
cespuglio	NOM
vibrare	VER:infi
seguito	NOM
ambientale	ADJ
spunto	NOM
catechina	NOM
desiderare	VER:cimp
inutilmente	ADV
raccontare	VER:infi
pertanto	ADV
immediatamente	ADV
ventilato	ADJ
socializzare	VER:infi
raccogliere	VER:pres
risalire	VER:cpre
voluttà	NOM
provocare	VER:infi
archeologia	NOM
ombrellone	NOM
strumento	NOM
scontato	ADJ
ideale	ADJ
inno	NOM
fede	NOM
voluto	ADJ
sé	NOM
porre	VER:pper
offerta	NOM
ingenuamente	ADV
tesoro	NOM
proposta	NOM
sconsiderato	ADJ
ottimo	ADJ
agio	NOM
denuncia	NOM
inventore	NOM
impedire	VER:pres
professionista	NOM
comportare	VER:pres
nascondere	VER:infi
umano	NOM
comodamente	ADV
nervosismo	NOM
acquisire	VER:infi
realmente	ADV
riparare	VER:pper
disporre	VER:pper
intraprendere	VER:infi
magnifico	NOM
talento	NOM
recupero	NOM
ingrediente	NOM
astronomico	ADJ
incontro	NOM
costruire	VER:pper
accogliere	VER:pper
apprezzato	ADJ
europeo	ADJ
sottoporre	VER:pper
fissare	VER:infi
editoria	NOM
asino	NOM
marca	NOM
riflettere	VER:pres
spogliare	VER:pper
innamorare	VER:infi
richiedere	VER:pper
desistere	VER:infi
allerta	NOM
marciapiede	NOM
rilevare	VER:pper
disegno	NOM
angoscia	NOM
foresta	NOM
beffa	NOM
comunicare	VER:infi
costruire	VER:cond
dimostrare	VER:pper
affrontare	VER:pres
formazione	NOM
familiare	NOM
descrivere	VER:infi
presente	ADJ
altrimenti	ADV
amarezza	NOM
grosso	ADJ
progettazione	NOM
viso	NOM
trattare	VER:cimp
dedurre	VER:infi
disabile	ADJ
sviluppo	NOM
produrre	VER:cpre
fuggire	VER:pper
allestire	VER:pper
folata	NOM
ferita	NOM
necessitare	VER:pres
caso	NOM
uso	NOM
divenire	VER:remo
dea	NOM
malfattore	NOM
sufficiente	ADJ
indagare	VER:infi
leggenda	NOM
teorico	ADJ
liberamente	ADV
furbo	ADJ
scultura	NOM
stipendio	NOM
ripiegare	VER:infi
rischiare	VER:pres
elencare	VER:pper
svegliare	VER:geru
offendere	VER:pres
dubbio	NOM
caratteristica	NOM
radiocollare	NOM
profondo	NOM
accettare	VER:infi
decennio	NOM
aritmetica	NOM
apertura	NOM
investimento	NOM
realizzare	VER:infi
probabilità	NOM
musicale	ADJ
incuriosire	VER:pres
gradino	NOM
arricchire	VER:pper
popolo	NOM
soffrire	VER:pper
lotteria	NOM
inoltre	ADV
abile	ADJ
aeronautico	ADJ
fa	ADV
ultimamente	ADV
pancia	NOM
realizzare	VER:pper
alternativa	NOM
requisito	NOM
ricostituire	VER:infi
morto	NOM
innamorare	VER:remo
romano	ADJ
illegalmente	ADV
evolutivo	ADJ
alternare	VER:futu
peggiore	ADJ
fondare	VER:pper
esploratore	NOM
affidare	VER:pres
rubare	VER:pper
monitorare	VER:pper
accademico	ADJ
interessato	ADJ
affascinante	ADJ
massiccio	NOM
canile	NOM
storiella	NOM
passo	NOM
abbandonare	VER:pper
compera	NOM
spaventare	VER:pres
test	NOM
esperto	NOM
codardia	NOM
paga	NOM
ingrassare	VER:infi
adolescente	NOM
fauna	NOM
discordante	ADJ
parsimonioso	ADJ
divertire	VER:futu
progetto	NOM
piacevole	ADJ
ripiego	NOM
controllare	VER:impf
sensazionale	ADJ
causa	NOM
gara	NOM
prestigio	NOM
stomaco	NOM
scorgere	VER
aumentare	VER:pper
raggio	NOM
interesse	NOM
follia	NOM
capitare	VER:infi
cruciverba	NOM
scappare	VER:remo
scolpito	ADJ
tedesco	ADJ
intervistare	VER:pper
maniera	NOM
capitano	NOM
superare	VER:remo
diritto	NOM
reale	ADJ
ferito	ADJ
imbianchino	NOM
raccontare	VER:pres
guerra	NOM
complesso	ADJ
conclusione	NOM
elemento	NOM
calore	NOM
successo	NOM
robot	NOM
questione	NOM
indagine	NOM
ipotizzare	VER:pper
ricercare	VER:infi
fondente	ADJ
riversare	VER:pper
mostrare	VER:infi
graduale	ADJ
trattare	VER:impf
regola	NOM
cieco	ADJ
dimagrante	ADJ
manifestare	VER:infi
sciocco	ADJ
basare	VER:pres
quadrare	VER:infi
inaugurare	VER:pper
indubbiamente	ADV
nascondere	VER:remo
creare	VER:cpre
necessità	NOM
sfruttare	VER:infi
tipico	ADJ
branco	NOM
migliorare	VER:infi
avventuroso	ADJ
accorgere	VER:pper
temere	VER:infi
discutere	VER:geru
ne	ADV
barbiere	NOM
contare	VER:infi
scoprire	VER:pper
rischiare	VER:impf
trasferire	VER:pper
scherzo	NOM
ricchezza	NOM
rispettare	VER:infi
malvagità	NOM
inconfondibile	ADJ
valere	VER:pres
ripagare	VER:pper
architettonico	ADJ
spettacolare	ADJ
misura	NOM
campo	NOM
intervenire	VER:pper
indispensabile	ADJ
ricominciare	VER:infi
alzare	VER:remo
paese	NOM
stancare	VER:pper
trionfare	VER:pres
annoiare	VER:pper
affermare	VER:pres
discendente	NOM
cittadino	NOM
possibilità	NOM
fantasia	NOM
consumo	NOM
sottolineare	VER:pres
costoso	ADJ
editoriale	ADJ
cima	NOM
raramente	ADV
inglese	NOM
presentare	VER:impf
disperazione	NOM
opera	NOM
telegiornale	NOM
comparare	VER:infi
inquinamento	NOM
cinta	NOM
importanza	NOM
saltare	VER:remo
riordinare	VER:infi
sponsor	NOM
estetica	NOM
garantire	VER:infi
traduttore	NOM
profano	NOM
professionalità	NOM
metallo	NOM
scottare	VER:impf
dieta	NOM
prenotazione	NOM
braccare	VER:pper
forza	NOM
motivo	NOM
onore	NOM
del	PRE:Det
gemello	NOM
scavalcare	VER:geru
rasoio	NOM
sguardo	NOM
servire	VER:infi
realtà	NOM
buono	ADJ
conseguenza	NOM
lista	NOM
permettere	VER:pper
menzogna	NOM
saziare	VER:pres
rubare	VER:remo
complicare	VER:remo
sepolto	NOM
curiosamente	ADV
guadagnare	VER:pper
degenza	NOM
ricostruire	VER:pper
bimbo	NOM
gettare	VER:pper
nazionale	ADJ
ozono	NOM
ultrasuono	NOM
specificatamente	ADV
grido	NOM
persino	ADV
preside	NOM
cacao	NOM
precedente	ADJ
implorare	VER:remo
tecnologia	NOM
mestiere	NOM
raggiungere	VER:pper
dopobarba	NOM
acquisto	NOM
dapprima	ADV
coprire	VER:pres
riflessione	NOM
soddisfatto	ADJ
liceo	NOM
terminare	VER:pper
media	NOM
mancare	VER:impf
iscrivere	VER:infi
cinese	NOM
sviluppare	VER:pper
girevole	ADJ
eccezionale	ADJ
centinaio	NOM
cercatore	NOM
concessione	NOM
costringere	VER:remo
sostenibile	ADJ
evento	NOM
falda	NOM
divertire	VER:infi
sentimento	NOM
decidere	VER:futu
maestro	NOM
specializzare	VER:pper
specie	NOM
atmosfera	NOM
direzionare	ADJ
collaborazione	NOM
persistere	VER:pres
cauto	ADJ
consiliare	ADJ
bravata	NOM
scappare	VER:infi
dedicare	VER:pper
improvvisare	VER:infi
competenza	NOM
politico	NOM
riferimento	NOM
avvisare	VER:infi
sopracciglio	NOM
capitare	VER:pper
quotidianamente	ADV
radiofonico	ADJ
promettere	VER:infi
assistere	VER:pper
gemello	ADJ
sogno	NOM
preoccupante	ADJ
incredibile	ADJ
soluzione	NOM
scioglimento	NOM
vinto	ADJ
confortevole	ADJ
vincere	VER:pper
riflettere	VER:cimp
whisky	NOM
quantità	NOM
invece	ADV
crollare	VER:pres
capotreno	NOM
oltre	ADV
esercitare	VER:infi
legame	NOM
spedizione	NOM
televisivo	ADJ
viaggiatore	NOM
pigrizia	NOM
statistica	NOM
scoprire	VER:infi
proprio	ADV
ingannare	VER:pper
cacciatore	NOM
inviare	VER:pper
fermare	VER:infi
critico	NOM
direttamente	ADV
subire	VER:infi
presenza	NOM
fata	NOM
gente	NOM
attesa	NOM
cesta	NOM
